AAAAATTTGCT -> AAAATTTGCTG
AAAACCCTAGA -> AAACCCTAGAT
AAAAGCGCTTA -> AAAGCGCTTAA
AAAATTTGCTG -> AAATTTGCTGT
AAACATTGCTG -> AACATTGCTGT
AAACCCTAGAT -> AACCCTAGATC
AAACGCCGGCT -> AACGCCGGCTA
AAACGGGCTTG -> AACGGGCTTGT
AAACGTCGGGG -> AACGTCGGGGA
AAACTAGCTAA -> AACTAGCTAAG
AAACTCCCAGG -> AACTCCCAGGG
AAACTGCCAAT -> AACTGCCAATT
AAAGAGAATGC -> AAGAGAATGCA
AAAGCGCTTAA -> AAGCGCTTAAG
AAAGGGAGTAC -> AAGGGAGTACA
AAAGTCGCTTG -> AAGTCGCTTGA
AAAGTCGGACA -> AAGTCGGACAC
AAAGTGCGGTT -> AAGTGCGGTTC
AAATATATAAT -> AATATATAATT
AAATCCTACTG -> AATCCTACTGA
AAATGCCAGTC -> AATGCCAGTCC
AAATGGCTCAG -> AATGGCTCAGA
AAATTCCACTA -> AATTCCACTAG
AAATTTGCTGT -> AATTTGCTGTC
AACACAAAGTC -> ACACAAAGTCG
AACACCCCGCA -> ACACCCCGCAC
AACACCGCACT -> ACACCGCACTC
AACACCTTAGC -> ACACCTTAGCT
AACACGAAACT -> ACACGAAACTC
AACACGGCGAG -> ACACGGCGAGT
AACAGAGCGCG -> ACAGAGCGCGA
AACATTCAGAA -> ACATTCAGAAG
AACATTGCTGT -> ACATTGCTGTA
AACCAGAATGA -> ACCAGAATGAA
AACCAGACGTT -> ACCAGACGTTC
AACCCCCCGAA -> ACCCCCCGAAG
AACCCTAGATC -> ACCCTAGATCT
AACCGCCCACC -> ACCGCCCACCA
AACCGTCCGTA -> ACCGTCCGTAC
AACCGTTCCGC -> ACCGTTCCGCG
AACCTCACGGA -> ACCTCACGGAA
AACGCCGGCTA -> ACGCCGGCTAT
AACGGCCTCTC -> ACGGCCTCTCA
AACGGGCTTGT -> ACGGGCTTGTA
AACGTCGGGGA -> ACGTCGGGGAC
AACGTGGTGGA -> ACGTGGTGGAG
AACTAGCTAAG -> ACTAGCTAAGG
AACTATATCCA -> ACTATATCCAT
AACTCAGTTAG -> ACTCAGTTAGA
AACTCCCAGGG -> ACTCCCAGGGT
AACTGCCAATT -> ACTGCCAATTG
AACTGGAGTAC -> ACTGGAGTACC
AACTGGCCAGC -> ACTGGCCAGCA
AAGAATGCTCC -> AGAATGCTCCT
AAGACAATTCC -> AGACAATTCCC
AAGAGAATGCA -> AGAGAATGCAT
AAGATGAAAGA -> AGATGAAAGAG
AAGCACTGAAC -> AGCACTGAACT
AAGCAGCATGA -> AGCAGCATGAC
AAGCCAATTCT -> AGCCAATTCTA
AAGCCCATTTA -> AGCCCATTTAA
AAGCGCTTAAG -> AGCGCTTAAGC
AAGCTCTTGCC -> AGCTCTTGCCT
AAGCTGCAACT -> AGCTGCAACTC
AAGGACAACAC -> AGGACAACACC
AAGGAGGCACG -> AGGAGGCACGG
AAGGATCGAGT -> AGGATCGAGTT
AAGGCACCGTT -> AGGCACCGTTA
AAGGCTACGGC -> AGGCTACGGCG
AAGGGAGTACA -> AGGGAGTACAG
AAGTAACCAGA -> AGTAACCAGAA
AAGTAGTGGTC -> AGTAGTGGTCT
AAGTATTGTGA -> AGTATTGTGAT
AAGTCAGCATT -> AGTCAGCATTC
AAGTCCACAAT -> AGTCCACAATT
AAGTCGCTTGA -> AGTCGCTTGAA
AAGTCGGACAC -> AGTCGGACACC
AAGTGCGGTTC -> AGTGCGGTTCA
AAGTGCGTGGG -> AGTGCGTGGGT
AAGTGTTCAGA -> AGTGTTCAGAT
AATAACTGGAG -> ATAACTGGAGT
AATAATGTTGG -> ATAATGTTGGG
AATACCTCGGC -> ATACCTCGGCA
AATACTGTCAA -> ATACTGTCAAT
AATACTGTGCT -> ATACTGTGCTC
AATATATAATT -> ATATATAATTG
AATCACCTGAG -> ATCACCTGAGG
AATCACTATCC -> ATCACTATCCC
AATCCCCCTGT -> ATCCCCCTGTC
AATCCCGATCG -> ATCCCGATCGT
AATCCTACTGA -> ATCCTACTGAC
AATCTATCGTG -> ATCTATCGTGA
AATGAAATGCC -> ATGAAATGCCA
AATGAACACGA -> ATGAACACGAA
AATGCATGTAA -> ATGCATGTAAT
AATGCCAGTCC -> ATGCCAGTCCA
AATGCTCCTTA -> ATGCTCCTTAC
AATGGCTCAGA -> ATGGCTCAGAA
AATGGTAGACC -> ATGGTAGACCA
AATGGTTAATA -> ATGGTTAATAA
AATGTTGGGAA -> ATGTTGGGAAA
AATTAGATAGT -> ATTAGATAGTA
AATTCCACTAG -> ATTCCACTAGG
AATTCCCAACC -> ATTCCCAACCG
AATTCTACTGC -> ATTCTACTGCT
AATTCTATTAG -> ATTCTATTAGG
AATTGGCGAGG -> ATTGGCGAGGA
AATTGTTATTG -> ATTGTTATTGG
AATTTACTCGA -> ATTTACTCGAG
AATTTCAGCGC -> ATTTCAGCGCC
AATTTGCTGTC -> ATTTGCTGTCT
ACAAAGTCGGA -> CAAAGTCGGAC
ACAACACCGCA -> CAACACCGCAC
ACAAGCCCATT -> CAAGCCCATTT
ACAATGGTAGA -> CAATGGTAGAC
ACAATTCCCAA -> CAATTCCCAAC
ACAATTCTACT -> CAATTCTACTG
ACACAAAGTCG -> CACAAAGTCGG
ACACCCACGCG -> CACCCACGCGA
ACACCCCGCAC -> CACCCCGCACG
ACACCGATTCA -> CACCGATTCAC
ACACCGCACTC -> CACCGCACTCG
ACACCTTAGCT -> CACCTTAGCTA
ACACGAAACTC -> CACGAAACTCC
ACACGGCGAGT -> CACGGCGAGTT
ACACGGTCCAC -> CACGGTCCACG
ACAGACCGTGC -> CAGACCGTGCC
ACAGAGCGCGA -> CAGAGCGCGAT
ACAGCCAACGT -> CAGCCAACGTG
ACAGGCGAGTG -> CAGGCGAGTGC
ACAGGTCACCG -> CAGGTCACCGG
ACAGTTAGTGG -> CAGTTAGTGGA
ACATCGCTACC -> CATCGCTACCA
ACATCTGAGTA -> CATCTGAGTAG
ACATTCAGAAG -> CATTCAGAAGG
ACATTGCTGTA -> CATTGCTGTAG
ACCAACACCTT -> CCAACACCTTA
ACCAAGCACTG -> CCAAGCACTGA
ACCACTCATAA -> CCACTCATAAA
ACCAGAATGAA -> CCAGAATGAAA
ACCAGACAGAC -> CCAGACAGACC
ACCAGACGTTC -> CCAGACGTTCC
ACCAGGCCTAG -> CCAGGCCTAGC
ACCATCCCAAG -> CCATCCCAAGC
ACCCACGCGAG -> CCCACGCGAGC
ACCCAGACCAG -> CCCAGACCAGG
ACCCCCCGAAG -> CCCCCCGAAGT
ACCCCGCACGG -> CCCCGCACGGC
ACCCGAGTTAG -> CCCGAGTTAGT
ACCCGGTTTCT -> CCCGGTTTCTT
ACCCTAACCTC -> CCCTAACCTCA
ACCCTAGATCT -> CCCTAGATCTC
ACCCTATGTAG -> CCCTATGTAGA
ACCGATTCACC -> CCGATTCACCC
ACCGCACTCGA -> CCGCACTCGAA
ACCGCCCACCA -> CCGCCCACCAG
ACCGCTCAGTG -> CCGCTCAGTGT
ACCGGATGGAT -> CCGGATGGATC
ACCGTCCGTAC -> CCGTCCGTACC
ACCGTGCCAGG -> CCGTGCCAGGC
ACCGTGTACGA -> CCGTGTACGAT
ACCGTTATCAT -> CCGTTATCATC
ACCGTTCCGCG -> CCGTTCCGCGA
ACCTAGCTCTC -> CCTAGCTCTCC
ACCTCACGGAA -> CCTCACGGAAT
ACCTCGGCACT -> CCTCGGCACTA
ACCTCGGCGTA -> CCTCGGCGTAT
ACCTGAGGGCC -> CCTGAGGGCCG
ACCTTAGCTAA -> CCTTAGCTAAT
ACGAAACTCCC -> CGAAACTCCCA
ACGATAGTCCA -> CGATAGTCCAA
ACGATTTGCGC -> CGATTTGCGCC
ACGCCCCGAAG -> CGCCCCGAAGG
ACGCCGACGGT -> CGCCGACGGTT
ACGCCGGCTAT -> CGCCGGCTATA
ACGCCTCGCAC -> CGCCTCGCACA
ACGCGAGCCCA -> CGCGAGCCCAA
ACGCTACAGGC -> CGCTACAGGCG
ACGGAATCTAT -> CGGAATCTATC
ACGGCAGACCG -> CGGCAGACCGT
ACGGCCTCTCA -> CGGCCTCTCAT
ACGGCGAGTTC -> CGGCGAGTTCA
ACGGCGTTGGG -> CGGCGTTGGGG
ACGGCTGTCTA -> CGGCTGTCTAA
ACGGCTGTTCA -> CGGCTGTTCAT
ACGGGAAGAAT -> CGGGAAGAATG
ACGGGCCGTTC -> CGGGCCGTTCC
ACGGGCTTGTA -> CGGGCTTGTAA
ACGGGGCAACC -> CGGGGCAACCG
ACGGTCCACGG -> CGGTCCACGGG
ACGGTGTGGCT -> CGGTGTGGCTC
ACGGTTTAGTG -> CGGTTTAGTGC
ACGTATAGTCG -> CGTATAGTCGG
ACGTCGGGGAC -> CGTCGGGGACA
ACGTGGTGGAG -> CGTGGTGGAGG
ACGTTCCCCGC -> CGTTCCCCGCG
ACTAATCACTA -> CTAATCACTAT
ACTAGCATTAC -> CTAGCATTACT
ACTAGCTAAGG -> CTAGCTAAGGC
ACTAGCTGAAG -> CTAGCTGAAGA
ACTAGGACGGG -> CTAGGACGGGG
ACTATATCCAT -> CTATATCCATC
ACTATCCCTGA -> CTATCCCTGAG
ACTCAGTTAGA -> CTCAGTTAGAT
ACTCATAAAAG -> CTCATAAAAGC
ACTCCCAGGGT -> CTCCCAGGGTC
ACTCCGCCGAA -> CTCCGCCGAAG
ACTCGAAGTAT -> CTCGAAGTATT
ACTCGAGTCTA -> CTCGAGTCTAG
ACTCTATTATA -> CTCTATTATAT
ACTCTCAGGTC -> CTCTCAGGTCC
ACTGAACTGGC -> CTGAACTGGCC
ACTGACTGCTT -> CTGACTGCTTC
ACTGAGGCTGT -> CTGAGGCTGTT
ACTGCCAATTG -> CTGCCAATTGG
ACTGCTAGAGC -> CTGCTAGAGCA
ACTGCTCTGGA -> CTGCTCTGGAT
ACTGCTTCGTT -> CTGCTTCGTTT
ACTGGAGTACC -> CTGGAGTACCC
ACTGGCCAGCA -> CTGGCCAGCAA
ACTGGTTGGCG -> CTGGTTGGCGA
ACTGTCAATGG -> CTGTCAATGGT
ACTGTGCTCAA -> CTGTGCTCAAG
ACTTAACGGCC -> CTTAACGGCCT
ACTTACACCGA -> CTTACACCGAT
ACTTCCCGCAG -> CTTCCCGCAGG
ACTTTCCCAAC -> CTTTCCCAACA
ACTTTCCGACT -> CTTTCCGACTT
AGAAGGACAAC -> GAAGGACAACA
AGAATCACCTG -> GAATCACCTGA
AGAATCCCGAT -> GAATCCCGATC
AGAATGAAATG -> GAATGAAATGC
AGAATGCATGT -> GAATGCATGTA
AGAATGCTCCT -> GAATGCTCCTT
AGACAATTCCC -> GACAATTCCCA
AGACAGACCGT -> GACAGACCGTG
AGACAGTTAGT -> GACAGTTAGTG
AGACCACTCAT -> GACCACTCATA
AGACCAGGCCT -> GACCAGGCCTA
AGACCGTGCCA -> GACCGTGCCAG
AGACCGTGTAC -> GACCGTGTACG
AGACCTAGCTC -> GACCTAGCTCT
AGACGTTCCCC -> GACGTTCCCCG
AGAGAATGCAT -> GAGAATGCATG
AGAGATGCAAC -> GAGATGCAACC
AGAGCAAATCC -> GAGCAAATCCT
AGAGCGCGATG -> GAGCGCGATGA
AGATAGTAATA -> GATAGTAATAA
AGATCGAAACT -> GATCGAAACTA
AGATCTCCCCA -> GATCTCCCCAT
AGATGAAAGAG -> GATGAAAGAGA
AGATGCAACCA -> GATGCAACCAG
AGATGGTGGAC -> GATGGTGGACG
AGATTTTGGTG -> GATTTTGGTGA
AGCAAAGTCGC -> GCAAAGTCGCT
AGCAAATCCTA -> GCAAATCCTAC
AGCACTAATCA -> GCACTAATCAC
AGCACTGAACT -> GCACTGAACTG
AGCAGCATGAC -> GCAGCATGACT
AGCATCTGGCG -> GCATCTGGCGT
AGCATGACTCT -> GCATGACTCTA
AGCATTACTTT -> GCATTACTTTC
AGCATTCGCGA -> GCATTCGCGAT
AGCCAACGTGG -> GCCAACGTGGT
AGCCAATTCTA -> GCCAATTCTAT
AGCCCAATTTA -> GCCCAATTTAC
AGCCCATTTAA -> GCCCATTTAAA
AGCCTTTAAAA -> GCCTTTAAAAC
AGCGCCCATGA -> GCGCCCATGAA
AGCGCGATGAA -> GCGCGATGAAG
AGCGCGATTGA -> GCGCGATTGAC
AGCGCTTAAGC -> GCGCTTAAGCC
AGCGGACTGGT -> GCGGACTGGTT
AGCGTCGCTCA -> GCGTCGCTCAT
AGCGTTTCACG -> GCGTTTCACGC
AGCTAAGGCAC -> GCTAAGGCACC
AGCTAATGAAC -> GCTAATGAACA
AGCTCTTGCCT -> GCTCTTGCCTA
AGCTGAAGATG -> GCTGAAGATGA
AGCTGATGGTG -> GCTGATGGTGG
AGCTGCAACTC -> GCTGCAACTCA
AGCTTGTCTTA -> GCTTGTCTTAC
AGCTTTCATGA -> GCTTTCATGAG
AGGAAATGGCT -> GGAAATGGCTC
AGGACAACACC -> GGACAACACCG
AGGACAAGCCC -> GGACAAGCCCA
AGGACGGGGCA -> GGACGGGGCAA
AGGAGCGCGAT -> GGAGCGCGATT
AGGAGGCACGG -> GGAGGCACGGT
AGGATCGAGTT -> GGATCGAGTTA
AGGCACCGTTA -> GGCACCGTTAT
AGGCACGGTGT -> GGCACGGTGTG
AGGCACTTAAC -> GGCACTTAACG
AGGCAGCACTA -> GGCAGCACTAA
AGGCCTAGCTT -> GGCCTAGCTTG
AGGCGAGTGCC -> GGCGAGTGCCC
AGGCTACGGCG -> GGCTACGGCGT
AGGCTGTTCGC -> GGCTGTTCGCT
AGGGAGTACAG -> GGGAGTACAGC
AGGGCCGACGG -> GGGCCGACGGG
AGGGTAGCATC -> GGGTAGCATCT
AGGGTCGCGCA -> GGGTCGCGCAA
AGGGTGATCCC -> GGGTGATCCCA
AGGTACTTCCC -> GGTACTTCCCG
AGGTCACCGGA -> GGTCACCGGAT
AGGTCCCCCCC -> GGTCCCCCCCC
AGTAACCAGAA -> GTAACCAGAAT
AGTAACCGTTC -> GTAACCGTTCC
AGTAATAATGT -> GTAATAATGTT
AGTACAGCCAA -> GTACAGCCAAC
AGTACCCGAGT -> GTACCCGAGTT
AGTAGCCTTTA -> GTAGCCTTTAA
AGTAGTGGTCT -> GTAGTGGTCTG
AGTATTGTGAT -> GTATTGTGATC
AGTCAGCATTC -> GTCAGCATTCG
AGTCCAAATAT -> GTCCAAATATA
AGTCCAATACC -> GTCCAATACCT
AGTCCACAATT -> GTCCACAATTC
AGTCGCTTGAA -> GTCGCTTGAAG
AGTCGGACACC -> GTCGGACACCC
AGTCGGGAAGT -> GTCGGGAAGTA
AGTCTAGGAGC -> GTCTAGGAGCG
AGTGACTGAGG -> GTGACTGAGGC
AGTGCAGCTTT -> GTGCAGCTTTC
AGTGCCCCGAT -> GTGCCCCGATA
AGTGCGGTTCA -> GTGCGGTTCAA
AGTGCGTGGGT -> GTGCGTGGGTC
AGTGCTCCTCC -> GTGCTCCTCCC
AGTGGATTTTA -> GTGGATTTTAC
AGTGGTCTGCA -> GTGGTCTGCAC
AGTGTGACCCT -> GTGTGACCCTA
AGTGTGTTGGG -> GTGTGTTGGGG
AGTGTTCAGAT -> GTGTTCAGATT
AGTTAGACAGT -> GTTAGACAGTT
AGTTAGATCGA -> GTTAGATCGAA
AGTTAGTAACC -> GTTAGTAACCG
AGTTAGTGGAT -> GTTAGTGGATT
AGTTCAACACA -> GTTCAACACAA
ATAAAAGCGCT -> TAAAAGCGCTT
ATAAAGTGCGG -> TAAAGTGCGGT
ATAACAGAGCG -> TAACAGAGCGC
ATAACTGGAGT -> TAACTGGAGTA
ATAATCCCCCT -> TAATCCCCCTG
ATAATGTTGGG -> TAATGTTGGGA
ATAATTGTTAT -> TAATTGTTATT
ATACCTCGGCA -> TACCTCGGCAC
ATACGATAGTC -> TACGATAGTCC
ATACTGTCAAT -> TACTGTCAATG
ATACTGTGCTC -> TACTGTGCTCA
ATAGCGTCGCT -> TAGCGTCGCTC
ATAGTAATAAT -> TAGTAATAATG
ATAGTCCAAAT -> TAGTCCAAATA
ATAGTCGGGAA -> TAGTCGGGAAG
ATATAATTGTT -> TATAATTGTTA
ATATAGCGTCG -> TATAGCGTCGC
ATATATAATTG -> TATATAATTGT
ATATATGAGAA -> TATATGAGAAT
ATATCCATCAT -> TATCCATCATC
ATATGAGAATC -> TATGAGAATCA
ATCAAATTCCA -> TCAAATTCCAC
ATCACCTGAGG -> TCACCTGAGGG
ATCACTATCCC -> TCACTATCCCT
ATCATCAAATT -> TCATCAAATTC
ATCATCTCACT -> TCATCTCACTC
ATCCATCATCA -> TCCATCATCAA
ATCCATGTATC -> TCCATGTATCG
ATCCCAAACGG -> TCCCAAACGGG
ATCCCAAGCTC -> TCCCAAGCTCT
ATCCCCCTGTC -> TCCCCCTGTCG
ATCCCGATCGT -> TCCCGATCGTC
ATCCCTGAGTG -> TCCCTGAGTGT
ATCCTACTGAC -> TCCTACTGACT
ATCGAAACTAG -> TCGAAACTAGC
ATCGAGTTAGA -> TCGAGTTAGAC
ATCGATACGAT -> TCGATACGATA
ATCGCCCAACT -> TCGCCCAACTA
ATCGCGTGTTA -> TCGCGTGTTAA
ATCGCTACCAT -> TCGCTACCATC
ATCGGGCTCAT -> TCGGGCTCATC
ATCGTCCTGAC -> TCGTCCTGACA
ATCGTGAGCTG -> TCGTGAGCTGA
ATCTATCGTGA -> TCTATCGTGAG
ATCTCACTCCG -> TCTCACTCCGC
ATCTCCCCATT -> TCTCCCCATTC
ATCTGAGTAGC -> TCTGAGTAGCC
ATCTGGCGTAG -> TCTGGCGTAGA
ATCTTTGTGGG -> TCTTTGTGGGT
ATGAAAGAGAA -> TGAAAGAGAAT
ATGAAATGCCA -> TGAAATGCCAG
ATGAACACGAA -> TGAACACGAAA
ATGAACATTCA -> TGAACATTCAG
ATGAAGTCCAC -> TGAAGTCCACA
ATGAATACTGT -> TGAATACTGTC
ATGACTCTATT -> TGACTCTATTA
ATGAGAATCAC -> TGAGAATCACC
ATGAGTGCTCC -> TGAGTGCTCCT
ATGCAACCAGA -> TGCAACCAGAC
ATGCATGTAAT -> TGCATGTAATA
ATGCCAGTCCA -> TGCCAGTCCAA
ATGCTACCCTA -> TGCTACCCTAT
ATGCTCCTTAC -> TGCTCCTTACT
ATGGATCTTTG -> TGGATCTTTGT
ATGGCTCAGAA -> TGGCTCAGAAT
ATGGTAGACCA -> TGGTAGACCAC
ATGGTGGACGC -> TGGTGGACGCT
ATGGTGGACGT -> TGGTGGACGTA
ATGGTTAATAA -> TGGTTAATAAC
ATGTAATACTG -> TGTAATACTGT
ATGTAGATGGT -> TGTAGATGGTG
ATGTATCGCCC -> TGTATCGCCCA
ATGTCGGATAT -> TGTCGGATATA
ATGTTGAATTA -> TGTTGAATTAG
ATGTTGGGAAA -> TGTTGGGAAAC
ATGTTTGTTAA -> TGTTTGTTAAA
ATTACTTTCCG -> TTACTTTCCGA
ATTAGATAGTA -> TTAGATAGTAA
ATTAGGGTGAT -> TTAGGGTGATC
ATTATATAGCG -> TTATATAGCGT
ATTCACCCGGT -> TTCACCCGGTT
ATTCAGAAGGA -> TTCAGAAGGAC
ATTCCACTAGG -> TTCCACTAGGA
ATTCCCAACCG -> TTCCCAACCGC
ATTCGATGAAC -> TTCGATGAACA
ATTCGCGATTT -> TTCGCGATTTC
ATTCTACGCCC -> TTCTACGCCCC
ATTCTACTGCT -> TTCTACTGCTA
ATTCTATTAGG -> TTCTATTAGGG
ATTGACCGCTC -> TTGACCGCTCA
ATTGACGGCTG -> TTGACGGCTGT
ATTGCTGTAGC -> TTGCTGTAGCG
ATTGGCGAGGA -> TTGGCGAGGAA
ATTGGTCGAAC -> TTGGTCGAACA
ATTGTGATCGA -> TTGTGATCGAT
ATTGTTATTGG -> TTGTTATTGGT
ATTTAAACTGC -> TTTAAACTGCC
ATTTAATTTCA -> TTTAATTTCAG
ATTTACTCGAG -> TTTACTCGAGT
ATTTATTGACG -> TTTATTGACGG
ATTTCAGCGCC -> TTTCAGCGCCC
ATTTCCTGATA -> TTTCCTGATAA
ATTTGCGCCAT -> TTTGCGCCATC
ATTTGCGGTAG -> TTTGCGGTAGG
ATTTGCTGTCT -> TTTGCTGTCTG
ATTTTACGGCT -> TTTTACGGCTG
ATTTTGGTGAG -> TTTTGGTGAGC
CAAAAATTTGC -> AAAAATTTGCT
CAAACGGGCTT -> AAACGGGCTTG
CAAACGTCGGG -> AAACGTCGGGG
CAAAGTCGCTT -> AAAGTCGCTTG
CAAAGTCGGAC -> AAAGTCGGACA
CAAATATATAA -> AAATATATAAT
CAAATCCTACT -> AAATCCTACTG
CAAATTCCACT -> AAATTCCACTA
CAACACAAAGT -> AACACAAAGTC
CAACACCGCAC -> AACACCGCACT
CAACACCTTAG -> AACACCTTAGC
CAACACGGCGA -> AACACGGCGAG
CAACCAGACGT -> AACCAGACGTT
CAACCCCCCGA -> AACCCCCCGAA
CAACCGCCCAC -> AACCGCCCACC
CAACCGTCCGT -> AACCGTCCGTA
CAACGTGGTGG -> AACGTGGTGGA
CAACTATATCC -> AACTATATCCA
CAACTCAGTTA -> AACTCAGTTAG
CAAGCACTGAA -> AAGCACTGAAC
CAAGCCCATTT -> AAGCCCATTTA
CAAGCTCTTGC -> AAGCTCTTGCC
CAAGCTGCAAC -> AAGCTGCAACT
CAAGGATCGAG -> AAGGATCGAGT
CAAGGCTACGG -> AAGGCTACGGC
CAATACCTCGG -> AATACCTCGGC
CAATGGTAGAC -> AATGGTAGACC
CAATGGTTAAT -> AATGGTTAATA
CAATTCCCAAC -> AATTCCCAACC
CAATTCTACTG -> AATTCTACTGC
CAATTCTATTA -> AATTCTATTAG
CAATTGGCGAG -> AATTGGCGAGG
CAATTTACTCG -> AATTTACTCGA
CACAAAGTCGG -> ACAAAGTCGGA
CACAATGGTAG -> ACAATGGTAGA
CACAATTCTAC -> ACAATTCTACT
CACATCGCTAC -> ACATCGCTACC
CACCAACACCT -> ACCAACACCTT
CACCAGACAGA -> ACCAGACAGAC
CACCCACGCGA -> ACCCACGCGAG
CACCCCGCACG -> ACCCCGCACGG
CACCCGGTTTC -> ACCCGGTTTCT
CACCGATTCAC -> ACCGATTCACC
CACCGCACTCG -> ACCGCACTCGA
CACCGGATGGA -> ACCGGATGGAT
CACCGTTATCA -> ACCGTTATCAT
CACCTCGGCGT -> ACCTCGGCGTA
CACCTGAGGGC -> ACCTGAGGGCC
CACCTTAGCTA -> ACCTTAGCTAA
CACGAAACTCC -> ACGAAACTCCC
CACGCCGACGG -> ACGCCGACGGT
CACGCGAGCCC -> ACGCGAGCCCA
CACGGAATCTA -> ACGGAATCTAT
CACGGCAGACC -> ACGGCAGACCG
CACGGCGAGTT -> ACGGCGAGTTC
CACGGGAAGAA -> ACGGGAAGAAT
CACGGTCCACG -> ACGGTCCACGG
CACGGTGTGGC -> ACGGTGTGGCT
CACTAATCACT -> ACTAATCACTA
CACTAGCTGAA -> ACTAGCTGAAG
CACTAGGACGG -> ACTAGGACGGG
CACTATCCCTG -> ACTATCCCTGA
CACTCATAAAA -> ACTCATAAAAG
CACTCCGCCGA -> ACTCCGCCGAA
CACTCGAAGTA -> ACTCGAAGTAT
CACTCTCAGGT -> ACTCTCAGGTC
CACTGAACTGG -> ACTGAACTGGC
CACTGCTCTGG -> ACTGCTCTGGA
CACTTAACGGC -> ACTTAACGGCC
CACTTTCCCAA -> ACTTTCCCAAC
CAGAAGGACAA -> AGAAGGACAAC
CAGAATCCCGA -> AGAATCCCGAT
CAGAATGAAAT -> AGAATGAAATG
CAGACAGACCG -> AGACAGACCGT
CAGACCAGGCC -> AGACCAGGCCT
CAGACCGTGCC -> AGACCGTGCCA
CAGACCGTGTA -> AGACCGTGTAC
CAGACGTTCCC -> AGACGTTCCCC
CAGAGCGCGAT -> AGAGCGCGATG
CAGATTTTGGT -> AGATTTTGGTG
CAGCAAAGTCG -> AGCAAAGTCGC
CAGCACTAATC -> AGCACTAATCA
CAGCATGACTC -> AGCATGACTCT
CAGCATTCGCG -> AGCATTCGCGA
CAGCCAACGTG -> AGCCAACGTGG
CAGCGCCCATG -> AGCGCCCATGA
CAGCTTTCATG -> AGCTTTCATGA
CAGGCACTTAA -> AGGCACTTAAC
CAGGCCTAGCT -> AGGCCTAGCTT
CAGGCGAGTGC -> AGGCGAGTGCC
CAGGGTAGCAT -> AGGGTAGCATC
CAGGGTCGCGC -> AGGGTCGCGCA
CAGGTCACCGG -> AGGTCACCGGA
CAGGTCCCCCC -> AGGTCCCCCCC
CAGTCCAATAC -> AGTCCAATACC
CAGTGTGACCC -> AGTGTGACCCT
CAGTTAGATCG -> AGTTAGATCGA
CAGTTAGTGGA -> AGTTAGTGGAT
CATAAAAGCGC -> ATAAAAGCGCT
CATCAAATTCC -> ATCAAATTCCA
CATCATCAAAT -> ATCATCAAATT
CATCCATGTAT -> ATCCATGTATC
CATCCCAAGCT -> ATCCCAAGCTC
CATCGCGTGTT -> ATCGCGTGTTA
CATCGCTACCA -> ATCGCTACCAT
CATCGGGCTCA -> ATCGGGCTCAT
CATCTCACTCC -> ATCTCACTCCG
CATCTGAGTAG -> ATCTGAGTAGC
CATCTGGCGTA -> ATCTGGCGTAG
CATGAATACTG -> ATGAATACTGT
CATGACTCTAT -> ATGACTCTATT
CATGAGTGCTC -> ATGAGTGCTCC
CATGCTACCCT -> ATGCTACCCTA
CATGTAATACT -> ATGTAATACTG
CATGTATCGCC -> ATGTATCGCCC
CATGTCGGATA -> ATGTCGGATAT
CATTACTTTCC -> ATTACTTTCCG
CATTCAGAAGG -> ATTCAGAAGGA
CATTCGATGAA -> ATTCGATGAAC
CATTCGCGATT -> ATTCGCGATTT
CATTGCTGTAG -> ATTGCTGTAGC
CATTTAAACTG -> ATTTAAACTGC
CATTTGCGGTA -> ATTTGCGGTAG
CCAAACGGGCT -> CAAACGGGCTT
CCAAATATATA -> CAAATATATAA
CCAACACCTTA -> CAACACCTTAG
CCAACACGGCG -> CAACACGGCGA
CCAACCGCCCA -> CAACCGCCCAC
CCAACGTGGTG -> CAACGTGGTGG
CCAACTATATC -> CAACTATATCC
CCAAGCACTGA -> CAAGCACTGAA
CCAAGCTCTTG -> CAAGCTCTTGC
CCAAGGCTACG -> CAAGGCTACGG
CCAATACCTCG -> CAATACCTCGG
CCAATTCTATT -> CAATTCTATTA
CCAATTGGCGA -> CAATTGGCGAG
CCAATTTACTC -> CAATTTACTCG
CCACAATGGTA -> CACAATGGTAG
CCACAATTCTA -> CACAATTCTAC
CCACCAGACAG -> CACCAGACAGA
CCACGCGAGCC -> CACGCGAGCCC
CCACGGGAAGA -> CACGGGAAGAA
CCACTAGGACG -> CACTAGGACGG
CCACTCATAAA -> CACTCATAAAA
CCAGAATGAAA -> CAGAATGAAAT
CCAGACAGACC -> CAGACAGACCG
CCAGACCAGGC -> CAGACCAGGCC
CCAGACGTTCC -> CAGACGTTCCC
CCAGCAAAGTC -> CAGCAAAGTCG
CCAGGCACTTA -> CAGGCACTTAA
CCAGGCCTAGC -> CAGGCCTAGCT
CCAGGGTCGCG -> CAGGGTCGCGC
CCAGTCCAATA -> CAGTCCAATAC
CCATCATCAAA -> CATCATCAAAT
CCATCCCAAGC -> CATCCCAAGCT
CCATCGCGTGT -> CATCGCGTGTT
CCATGAATACT -> CATGAATACTG
CCATGTATCGC -> CATGTATCGCC
CCATTCGATGA -> CATTCGATGAA
CCATTTAAACT -> CATTTAAACTG
CCCAAACGGGC -> CCAAACGGGCT
CCCAACACGGC -> CCAACACGGCG
CCCAACCGCCC -> CCAACCGCCCA
CCCAACTATAT -> CCAACTATATC
CCCAAGCTCTT -> CCAAGCTCTTG
CCCAAGGCTAC -> CCAAGGCTACG
CCCAATTTACT -> CCAATTTACTC
CCCACAATGGT -> CCACAATGGTA
CCCACCAGACA -> CCACCAGACAG
CCCACGCGAGC -> CCACGCGAGCC
CCCAGACCAGG -> CCAGACCAGGC
CCCAGGGTCGC -> CCAGGGTCGCG
CCCATGAATAC -> CCATGAATACT
CCCATTCGATG -> CCATTCGATGA
CCCATTTAAAC -> CCATTTAAACT
CCCCACAATGG -> CCCACAATGGT
CCCCATTCGAT -> CCCATTCGATG
CCCCCACAATG -> CCCCACAATGG
CCCCCCACAAT -> CCCCCACAATG
CCCCCCCACAA -> CCCCCCACAAT
CCCCCCCCACA -> CCCCCCCACAA
CCCCCCGAAGT -> CCCCCGAAGTG
CCCCCGAAGTG -> CCCCGAAGTGC
CCCCCTGTCGC -> CCCCTGTCGCT
CCCCGAAGGAG -> CCCGAAGGAGG
CCCCGAAGTGC -> CCCGAAGTGCG
CCCCGATAATC -> CCCGATAATCC
CCCCGCACGGC -> CCCGCACGGCA
CCCCGCGCAAA -> CCCGCGCAAAC
CCCCTGTCGCT -> CCCTGTCGCTT
CCCGAAGGAGG -> CCGAAGGAGGC
CCCGAAGTGCG -> CCGAAGTGCGT
CCCGAGTTAGT -> CCGAGTTAGTA
CCCGATAATCC -> CCGATAATCCC
CCCGATCGTCC -> CCGATCGTCCT
CCCGCACGGCA -> CCGCACGGCAG
CCCGCAGGGTA -> CCGCAGGGTAG
CCCGCGCAAAC -> CCGCGCAAACG
CCCGGTTTCTT -> CCGGTTTCTTT
CCCTAACCTCA -> CCTAACCTCAC
CCCTAGATCTC -> CCTAGATCTCC
CCCTATGTAGA -> CCTATGTAGAT
CCCTGAGTGTG -> CCTGAGTGTGT
CCCTGTCGCTT -> CCTGTCGCTTA
CCGAAGGAGGC -> CGAAGGAGGCA
CCGAAGTGCGT -> CGAAGTGCGTG
CCGAAGTGTTC -> CGAAGTGTTCA
CCGACGGGCCG -> CGACGGGCCGT
CCGACGGTTTA -> CGACGGTTTAG
CCGACTTACAC -> CGACTTACACC
CCGAGTTAGTA -> CGAGTTAGTAA
CCGATAATCCC -> CGATAATCCCC
CCGATCGTCCT -> CGATCGTCCTG
CCGATTCACCC -> CGATTCACCCG
CCGCACGGCAG -> CGCACGGCAGA
CCGCACTCGAA -> CGCACTCGAAG
CCGCAGGGTAG -> CGCAGGGTAGC
CCGCCCACCAG -> CGCCCACCAGA
CCGCCGAAGTG -> CGCCGAAGTGT
CCGCGAGGCAG -> CGCGAGGCAGC
CCGCGCAAACG -> CGCGCAAACGT
CCGCTCAGTGT -> CGCTCAGTGTG
CCGGATGGATC -> CGGATGGATCT
CCGGCACTGCT -> CGGCACTGCTC
CCGGCTATAAC -> CGGCTATAACA
CCGGTTTCTTT -> CGGTTTCTTTA
CCGTACCCAGA -> CGTACCCAGAC
CCGTCCGTACC -> CGTCCGTACCC
CCGTGCCAGGC -> CGTGCCAGGCA
CCGTGTACGAT -> CGTGTACGATT
CCGTTATCATC -> CGTTATCATCT
CCGTTCCGCGA -> CGTTCCGCGAG
CCGTTCCTCAC -> CGTTCCTCACC
CCGTTCGTCGT -> CGTTCGTCGTC
CCTAACCTCAC -> CTAACCTCACG
CCTAAGACAAT -> CTAAGACAATT
CCTACTGACTG -> CTACTGACTGC
CCTAGATCTCC -> CTAGATCTCCC
CCTAGCTCTCC -> CTAGCTCTCCT
CCTAGCTTGTC -> CTAGCTTGTCT
CCTATGTAGAT -> CTATGTAGATG
CCTCACCTCGG -> CTCACCTCGGC
CCTCACGGAAT -> CTCACGGAATC
CCTCCCAAGGC -> CTCCCAAGGCT
CCTCGCACATC -> CTCGCACATCG
CCTCGGCACTA -> CTCGGCACTAG
CCTCGGCGTAT -> CTCGGCGTATT
CCTCTCATGCT -> CTCTCATGCTA
CCTCTCCGTTC -> CTCTCCGTTCG
CCTGACACGGT -> CTGACACGGTC
CCTGAGGGCCG -> CTGAGGGCCGA
CCTGAGTGTGT -> CTGAGTGTGTT
CCTGATAAAGT -> CTGATAAAGTG
CCTGTCGCTTA -> CTGTCGCTTAG
CCTTACTAGCA -> CTTACTAGCAT
CCTTAGCTAAT -> CTTAGCTAATG
CCTTTAAAACC -> CTTTAAAACCC
CGAAACTAGCT -> GAAACTAGCTA
CGAAACTCCCA -> GAAACTCCCAG
CGAACACCCCG -> GAACACCCCGC
CGAAGGAGGCA -> GAAGGAGGCAC
CGAAGTATTGT -> GAAGTATTGTG
CGAAGTGCGTG -> GAAGTGCGTGG
CGAAGTGTTCA -> GAAGTGTTCAG
CGACAGGTCAC -> GACAGGTCACC
CGACGGGCCGT -> GACGGGCCGTT
CGACGGTTTAG -> GACGGTTTAGT
CGACTTACACC -> GACTTACACCG
CGAGCCCAATT -> GAGCCCAATTT
CGAGGAAATGG -> GAGGAAATGGC
CGAGGCAGCAC -> GAGGCAGCACT
CGAGTCTAGGA -> GAGTCTAGGAG
CGAGTGCCCCG -> GAGTGCCCCGA
CGAGTTAGACA -> GAGTTAGACAG
CGAGTTAGTAA -> GAGTTAGTAAC
CGAGTTCAACA -> GAGTTCAACAC
CGATAATCCCC -> GATAATCCCCC
CGATACGATAG -> GATACGATAGT
CGATAGTCCAA -> GATAGTCCAAA
CGATCGTCCTG -> GATCGTCCTGA
CGATGAACATT -> GATGAACATTC
CGATGAAGTCC -> GATGAAGTCCA
CGATGTTTGTT -> GATGTTTGTTA
CGATTCACCCG -> GATTCACCCGG
CGATTGACCGC -> GATTGACCGCT
CGATTTAATTT -> GATTTAATTTC
CGATTTATTGA -> GATTTATTGAC
CGATTTCCTGA -> GATTTCCTGAT
CGATTTGCGCC -> GATTTGCGCCA
CGCAAACGTCG -> GCAAACGTCGG
CGCAAGGATCG -> GCAAGGATCGA
CGCACATCGCT -> GCACATCGCTA
CGCACGGCAGA -> GCACGGCAGAC
CGCACTCGAAG -> GCACTCGAAGT
CGCAGGGTAGC -> GCAGGGTAGCA
CGCATTTGCGG -> GCATTTGCGGT
CGCCATCGCGT -> GCCATCGCGTG
CGCCCAACTAT -> GCCCAACTATA
CGCCCACCAGA -> GCCCACCAGAC
CGCCCATGAAT -> GCCCATGAATA
CGCCCCGAAGG -> GCCCCGAAGGA
CGCCGAAGTGT -> GCCGAAGTGTT
CGCCGACGGTT -> GCCGACGGTTT
CGCCGGCTATA -> GCCGGCTATAA
CGCCTCGCACA -> GCCTCGCACAT
CGCGAGCCCAA -> GCGAGCCCAAT
CGCGAGGCAGC -> GCGAGGCAGCA
CGCGATGAAGT -> GCGATGAAGTC
CGCGATTGACC -> GCGATTGACCG
CGCGATTTCCT -> GCGATTTCCTG
CGCGCAAACGT -> GCGCAAACGTC
CGCGCAAGGAT -> GCGCAAGGATC
CGCGTGTTAAA -> GCGTGTTAAAC
CGCTACAGGCG -> GCTACAGGCGA
CGCTACCATCC -> GCTACCATCCC
CGCTCAGTGTG -> GCTCAGTGTGA
CGCTCATCGGG -> GCTCATCGGGC
CGCTTAAGCCA -> GCTTAAGCCAA
CGCTTAGACCT -> GCTTAGACCTA
CGCTTGAAGTC -> GCTTGAAGTCA
CGCTTTCAACC -> GCTTTCAACCC
CGGAATCTATC -> GGAATCTATCG
CGGACACCCAC -> GGACACCCACG
CGGACTGGTTG -> GGACTGGTTGG
CGGATATATGA -> GGATATATGAG
CGGATGGATCT -> GGATGGATCTT
CGGCACTAGCT -> GGCACTAGCTG
CGGCACTGCTC -> GGCACTGCTCT
CGGCAGACCGT -> GGCAGACCGTG
CGGCCTCTCAT -> GGCCTCTCATG
CGGCGAGTTCA -> GGCGAGTTCAA
CGGCGTATTCT -> GGCGTATTCTA
CGGCGTTGGGG -> GGCGTTGGGGG
CGGCTATAACA -> GGCTATAACAG
CGGCTGTCTAA -> GGCTGTCTAAG
CGGCTGTTCAT -> GGCTGTTCATG
CGGGAAGAATG -> GGGAAGAATGC
CGGGAAGTAGT -> GGGAAGTAGTG
CGGGCCGTTCC -> GGGCCGTTCCT
CGGGCTCATCC -> GGGCTCATCCA
CGGGCTTGTAA -> GGGCTTGTAAG
CGGGGACATCT -> GGGGACATCTG
CGGGGCAACCG -> GGGGCAACCGT
CGGTAGGACAA -> GGTAGGACAAG
CGGTCCACGGG -> GGTCCACGGGA
CGGTGTGGCTC -> GGTGTGGCTCC
CGGTTCAAAAA -> GGTTCAAAAAT
CGGTTTAGTGC -> GGTTTAGTGCA
CGGTTTCTTTA -> GGTTTCTTTAC
CGTACCCAGAC -> GTACCCAGACC
CGTAGAGATGC -> GTAGAGATGCA
CGTATAGTCGG -> GTATAGTCGGG
CGTATTCTACG -> GTATTCTACGC
CGTCCGTACCC -> GTCCGTACCCA
CGTCCTGACAC -> GTCCTGACACG
CGTCGATTTAT -> GTCGATTTATT
CGTCGCTCATC -> GTCGCTCATCG
CGTCGGGGACA -> GTCGGGGACAT
CGTCGTCGATT -> GTCGTCGATTT
CGTGAGCTGAT -> GTGAGCTGATG
CGTGCCAGGCA -> GTGCCAGGCAC
CGTGGGTCTTC -> GTGGGTCTTCA
CGTGGTGGAGG -> GTGGTGGAGGT
CGTGTACGATT -> GTGTACGATTT
CGTGTTAAACG -> GTGTTAAACGC
CGTTATCATCT -> GTTATCATCTC
CGTTCCCCGCG -> GTTCCCCGCGC
CGTTCCGCGAG -> GTTCCGCGAGG
CGTTCCTCACC -> GTTCCTCACCT
CGTTCGTCGTC -> GTTCGTCGTCG
CGTTGGGGGGA -> GTTGGGGGGAG
CGTTTCACGCC -> GTTTCACGCCG
CGTTTGCTGCA -> GTTTGCTGCAC
CTAACCTCACG -> TAACCTCACGG
CTAAGACAATT -> TAAGACAATTC
CTAAGGCACCG -> TAAGGCACCGT
CTAAGTAACCA -> TAAGTAACCAG
CTAATCACTAT -> TAATCACTATC
CTAATGAACAC -> TAATGAACACG
CTACAGGCGAG -> TACAGGCGAGT
CTACCATCCCA -> TACCATCCCAA
CTACCCTATGT -> TACCCTATGTA
CTACGCCCCGA -> TACGCCCCGAA
CTACGGCGTTG -> TACGGCGTTGG
CTACTGACTGC -> TACTGACTGCT
CTACTGCTAGA -> TACTGCTAGAG
CTAGAGCAAAT -> TAGAGCAAATC
CTAGATCTCCC -> TAGATCTCCCC
CTAGCATTACT -> TAGCATTACTT
CTAGCTAAGGC -> TAGCTAAGGCA
CTAGCTCTCCT -> TAGCTCTCCTA
CTAGCTGAAGA -> TAGCTGAAGAT
CTAGCTTGTCT -> TAGCTTGTCTT
CTAGGACGGGG -> TAGGACGGGGC
CTAGGAGCGCG -> TAGGAGCGCGA
CTATAACAGAG -> TATAACAGAGC
CTATATCCATC -> TATATCCATCA
CTATCCCTGAG -> TATCCCTGAGT
CTATCGTGAGC -> TATCGTGAGCT
CTATGTAGATG -> TATGTAGATGG
CTATTAGGGTG -> TATTAGGGTGA
CTATTATATAG -> TATTATATAGC
CTCAAGCTGCA -> TCAAGCTGCAA
CTCACCTCGGC -> TCACCTCGGCG
CTCACGGAATC -> TCACGGAATCT
CTCACTCCGCC -> TCACTCCGCCG
CTCAGAATCCC -> TCAGAATCCCG
CTCAGGTCCCC -> TCAGGTCCCCC
CTCAGTGTGAC -> TCAGTGTGACC
CTCAGTTAGAT -> TCAGTTAGATC
CTCATAAAAGC -> TCATAAAAGCG
CTCATCCATGT -> TCATCCATGTA
CTCATCGGGCT -> TCATCGGGCTC
CTCATGCTACC -> TCATGCTACCC
CTCCCAAGGCT -> TCCCAAGGCTA
CTCCCAGGGTC -> TCCCAGGGTCG
CTCCCCATTCG -> TCCCCATTCGA
CTCCGCCGAAG -> TCCGCCGAAGT
CTCCGGCACTG -> TCCGGCACTGC
CTCCGTTCGTC -> TCCGTTCGTCG
CTCCTCCCAAG -> TCCTCCCAAGG
CTCCTTACTAG -> TCCTTACTAGC
CTCGAAGTATT -> TCGAAGTATTG
CTCGAGTCTAG -> TCGAGTCTAGG
CTCGCACATCG -> TCGCACATCGC
CTCGGCACTAG -> TCGGCACTAGC
CTCGGCGTATT -> TCGGCGTATTC
CTCTATTATAT -> TCTATTATATA
CTCTCAGGTCC -> TCTCAGGTCCC
CTCTCATGCTA -> TCTCATGCTAC
CTCTCCGTTCG -> TCTCCGTTCGT
CTCTGGATGTT -> TCTGGATGTTG
CTCTTGCCTAA -> TCTTGCCTAAG
CTGAACTGGCC -> TGAACTGGCCA
CTGAAGATGAA -> TGAAGATGAAA
CTGACACGGTC -> TGACACGGTCC
CTGACTGCTTC -> TGACTGCTTCG
CTGAGGCTGTT -> TGAGGCTGTTC
CTGAGGGCCGA -> TGAGGGCCGAC
CTGAGTAGCCT -> TGAGTAGCCTT
CTGAGTGTGTT -> TGAGTGTGTTG
CTGATAAAGTG -> TGATAAAGTGC
CTGATGGTGGA -> TGATGGTGGAC
CTGCAACTCAG -> TGCAACTCAGT
CTGCACCAACA -> TGCACCAACAC
CTGCACTCTCA -> TGCACTCTCAG
CTGCCAATTGG -> TGCCAATTGGC
CTGCGATGTTT -> TGCGATGTTTG
CTGCTAGAGCA -> TGCTAGAGCAA
CTGCTCTGGAT -> TGCTCTGGATG
CTGCTTCGTTT -> TGCTTCGTTTG
CTGGAGTACCC -> TGGAGTACCCG
CTGGATGTTGA -> TGGATGTTGAA
CTGGCCAGCAA -> TGGCCAGCAAA
CTGGCGTAGAG -> TGGCGTAGAGA
CTGGTTGGCGA -> TGGTTGGCGAT
CTGTAGCGTTT -> TGTAGCGTTTC
CTGTCAATGGT -> TGTCAATGGTT
CTGTCGCTTAG -> TGTCGCTTAGA
CTGTCTAAGTA -> TGTCTAAGTAA
CTGTCTGCGAT -> TGTCTGCGATG
CTGTGCTCAAG -> TGTGCTCAAGC
CTGTTCATGTC -> TGTTCATGTCG
CTGTTCGCTTT -> TGTTCGCTTTC
CTTAACGGCCT -> TTAACGGCCTC
CTTAAGCCAAT -> TTAAGCCAATT
CTTACACCGAT -> TTACACCGATT
CTTACGCCTCG -> TTACGCCTCGC
CTTACTAGCAT -> TTACTAGCATT
CTTAGACCTAG -> TTAGACCTAGC
CTTAGCTAATG -> TTAGCTAATGA
CTTCACTTTCC -> TTCACTTTCCC
CTTCCCGCAGG -> TTCCCGCAGGG
CTTCGTTTGCT -> TTCGTTTGCTG
CTTGAAGTCAG -> TTGAAGTCAGC
CTTGCCTAAGA -> TTGCCTAAGAC
CTTGTAAGCAG -> TTGTAAGCAGC
CTTGTCTTACG -> TTGTCTTACGC
CTTTAAAACCC -> TTTAAAACCCT
CTTTACCAAGC -> TTTACCAAGCA
CTTTCAACCCC -> TTTCAACCCCC
CTTTCATGAGT -> TTTCATGAGTG
CTTTCCCAACA -> TTTCCCAACAC
CTTTCCGACTT -> TTTCCGACTTA
CTTTGTGGGTT -> TTTGTGGGTTG
GAAACATTGCT -> AAACATTGCTG
GAAACTAGCTA -> AAACTAGCTAA
GAAACTCCCAG -> AAACTCCCAGG
GAAAGAGAATG -> AAAGAGAATGC
GAAATGCCAGT -> AAATGCCAGTC
GAAATGGCTCA -> AAATGGCTCAG
GAACACCCCGC -> AACACCCCGCA
GAACACGAAAC -> AACACGAAACT
GAACATTCAGA -> AACATTCAGAA
GAACTGGCCAG -> AACTGGCCAGC
GAAGAATGCTC -> AAGAATGCTCC
GAAGATGAAAG -> AAGATGAAAGA
GAAGGACAACA -> AAGGACAACAC
GAAGGAGGCAC -> AAGGAGGCACG
GAAGTAGTGGT -> AAGTAGTGGTC
GAAGTATTGTG -> AAGTATTGTGA
GAAGTCAGCAT -> AAGTCAGCATT
GAAGTCCACAA -> AAGTCCACAAT
GAAGTGCGTGG -> AAGTGCGTGGG
GAAGTGTTCAG -> AAGTGTTCAGA
GAATACTGTCA -> AATACTGTCAA
GAATCACCTGA -> AATCACCTGAG
GAATCCCGATC -> AATCCCGATCG
GAATCTATCGT -> AATCTATCGTG
GAATGAAATGC -> AATGAAATGCC
GAATGCATGTA -> AATGCATGTAA
GAATGCTCCTT -> AATGCTCCTTA
GAATTAGATAG -> AATTAGATAGT
GACAACACCGC -> ACAACACCGCA
GACAAGCCCAT -> ACAAGCCCATT
GACAATTCCCA -> ACAATTCCCAA
GACACCCACGC -> ACACCCACGCG
GACACGGTCCA -> ACACGGTCCAC
GACAGACCGTG -> ACAGACCGTGC
GACAGGTCACC -> ACAGGTCACCG
GACAGTTAGTG -> ACAGTTAGTGG
GACATCTGAGT -> ACATCTGAGTA
GACCACTCATA -> ACCACTCATAA
GACCAGGCCTA -> ACCAGGCCTAG
GACCCTAACCT -> ACCCTAACCTC
GACCGCTCAGT -> ACCGCTCAGTG
GACCGTGCCAG -> ACCGTGCCAGG
GACCGTGTACG -> ACCGTGTACGA
GACCTAGCTCT -> ACCTAGCTCTC
GACGCTACAGG -> ACGCTACAGGC
GACGGCTGTTC -> ACGGCTGTTCA
GACGGGCCGTT -> ACGGGCCGTTC
GACGGGGCAAC -> ACGGGGCAACC
GACGGTTTAGT -> ACGGTTTAGTG
GACGTATAGTC -> ACGTATAGTCG
GACGTTCCCCG -> ACGTTCCCCGC
GACTCTATTAT -> ACTCTATTATA
GACTGAGGCTG -> ACTGAGGCTGT
GACTGCTTCGT -> ACTGCTTCGTT
GACTGGTTGGC -> ACTGGTTGGCG
GACTTACACCG -> ACTTACACCGA
GAGAATCACCT -> AGAATCACCTG
GAGAATGCATG -> AGAATGCATGT
GAGATGCAACC -> AGATGCAACCA
GAGCAAATCCT -> AGCAAATCCTA
GAGCCCAATTT -> AGCCCAATTTA
GAGCGCGATGA -> AGCGCGATGAA
GAGCGCGATTG -> AGCGCGATTGA
GAGCGGACTGG -> AGCGGACTGGT
GAGCTGATGGT -> AGCTGATGGTG
GAGGAAATGGC -> AGGAAATGGCT
GAGGCACGGTG -> AGGCACGGTGT
GAGGCAGCACT -> AGGCAGCACTA
GAGGCTGTTCG -> AGGCTGTTCGC
GAGGGCCGACG -> AGGGCCGACGG
GAGGTACTTCC -> AGGTACTTCCC
GAGTACAGCCA -> AGTACAGCCAA
GAGTACCCGAG -> AGTACCCGAGT
GAGTAGCCTTT -> AGTAGCCTTTA
GAGTCTAGGAG -> AGTCTAGGAGC
GAGTGACTGAG -> AGTGACTGAGG
GAGTGCCCCGA -> AGTGCCCCGAT
GAGTGCTCCTC -> AGTGCTCCTCC
GAGTGTGTTGG -> AGTGTGTTGGG
GAGTTAGACAG -> AGTTAGACAGT
GAGTTAGTAAC -> AGTTAGTAACC
GAGTTCAACAC -> AGTTCAACACA
GATAAAGTGCG -> ATAAAGTGCGG
GATAATCCCCC -> ATAATCCCCCT
GATACGATAGT -> ATACGATAGTC
GATAGTAATAA -> ATAGTAATAAT
GATAGTCCAAA -> ATAGTCCAAAT
GATATATGAGA -> ATATATGAGAA
GATCCCAAACG -> ATCCCAAACGG
GATCGAAACTA -> ATCGAAACTAG
GATCGAGTTAG -> ATCGAGTTAGA
GATCGATACGA -> ATCGATACGAT
GATCGTCCTGA -> ATCGTCCTGAC
GATCTCCCCAT -> ATCTCCCCATT
GATCTTTGTGG -> ATCTTTGTGGG
GATGAAAGAGA -> ATGAAAGAGAA
GATGAACATTC -> ATGAACATTCA
GATGAAGTCCA -> ATGAAGTCCAC
GATGCAACCAG -> ATGCAACCAGA
GATGGATCTTT -> ATGGATCTTTG
GATGGTGGACG -> ATGGTGGACGC,ATGGTGGACGT
GATGTTGAATT -> ATGTTGAATTA
GATGTTTGTTA -> ATGTTTGTTAA
GATTCACCCGG -> ATTCACCCGGT
GATTGACCGCT -> ATTGACCGCTC
GATTTAATTTC -> ATTTAATTTCA
GATTTATTGAC -> ATTTATTGACG
GATTTCCTGAT -> ATTTCCTGATA
GATTTGCGCCA -> ATTTGCGCCAT
GATTTTACGGC -> ATTTTACGGCT
GATTTTGGTGA -> ATTTTGGTGAG
GCAAACGTCGG -> CAAACGTCGGG
GCAAAGTCGCT -> CAAAGTCGCTT
GCAAATCCTAC -> CAAATCCTACT
GCAACCAGACG -> CAACCAGACGT
GCAACCGTCCG -> CAACCGTCCGT
GCAACTCAGTT -> CAACTCAGTTA
GCAAGGATCGA -> CAAGGATCGAG
GCACATCGCTA -> CACATCGCTAC
GCACCAACACC -> CACCAACACCT
GCACCGTTATC -> CACCGTTATCA
GCACGGCAGAC -> CACGGCAGACC
GCACGGTGTGG -> CACGGTGTGGC
GCACTAATCAC -> CACTAATCACT
GCACTAGCTGA -> CACTAGCTGAA
GCACTCGAAGT -> CACTCGAAGTA
GCACTCTCAGG -> CACTCTCAGGT
GCACTGAACTG -> CACTGAACTGG
GCACTGCTCTG -> CACTGCTCTGG
GCACTTAACGG -> CACTTAACGGC
GCAGACCGTGT -> CAGACCGTGTA
GCAGCACTAAT -> CAGCACTAATC
GCAGCATGACT -> CAGCATGACTC
GCAGCTTTCAT -> CAGCTTTCATG
GCAGGGTAGCA -> CAGGGTAGCAT
GCATCTGGCGT -> CATCTGGCGTA
GCATGACTCTA -> CATGACTCTAT
GCATGTAATAC -> CATGTAATACT
GCATTACTTTC -> CATTACTTTCC
GCATTCGCGAT -> CATTCGCGATT
GCATTTGCGGT -> CATTTGCGGTA
GCCAACGTGGT -> CCAACGTGGTG
GCCAATTCTAT -> CCAATTCTATT
GCCAATTGGCG -> CCAATTGGCGA
GCCAGCAAAGT -> CCAGCAAAGTC
GCCAGGCACTT -> CCAGGCACTTA
GCCAGTCCAAT -> CCAGTCCAATA
GCCATCGCGTG -> CCATCGCGTGT
GCCCAACTATA -> CCCAACTATAT
GCCCAATTTAC -> CCCAATTTACT
GCCCACCAGAC -> CCCACCAGACA
GCCCATGAATA -> CCCATGAATAC
GCCCATTTAAA -> CCCATTTAAAC
GCCCCGAAGGA -> CCCCGAAGGAG
GCCCCGATAAT -> CCCCGATAATC
GCCGAAGTGTT -> CCGAAGTGTTC
GCCGACGGGCC -> CCGACGGGCCG
GCCGACGGTTT -> CCGACGGTTTA
GCCGGCTATAA -> CCGGCTATAAC
GCCGTTCCTCA -> CCGTTCCTCAC
GCCTAAGACAA -> CCTAAGACAAT
GCCTAGCTTGT -> CCTAGCTTGTC
GCCTCGCACAT -> CCTCGCACATC
GCCTCTCATGC -> CCTCTCATGCT
GCCTCTCCGTT -> CCTCTCCGTTC
GCCTTTAAAAC -> CCTTTAAAACC
GCGACAGGTCA -> CGACAGGTCAC
GCGAGCCCAAT -> CGAGCCCAATT
GCGAGGAAATG -> CGAGGAAATGG
GCGAGGCAGCA -> CGAGGCAGCAC
GCGAGTGCCCC -> CGAGTGCCCCG
GCGAGTTCAAC -> CGAGTTCAACA
GCGATGAAGTC -> CGATGAAGTCC
GCGATGTTTGT -> CGATGTTTGTT
GCGATTGACCG -> CGATTGACCGC
GCGATTTAATT -> CGATTTAATTT
GCGATTTCCTG -> CGATTTCCTGA
GCGCAAACGTC -> CGCAAACGTCG
GCGCAAGGATC -> CGCAAGGATCG
GCGCATTTGCG -> CGCATTTGCGG
GCGCCATCGCG -> CGCCATCGCGT
GCGCCCATGAA -> CGCCCATGAAT
GCGCGATGAAG -> CGCGATGAAGT
GCGCGATTGAC -> CGCGATTGACC
GCGCTTAAGCC -> CGCTTAAGCCA
GCGGACTGGTT -> CGGACTGGTTG
GCGGTAGGACA -> CGGTAGGACAA
GCGGTTCAAAA -> CGGTTCAAAAA
GCGTAGAGATG -> CGTAGAGATGC
GCGTATTCTAC -> CGTATTCTACG
GCGTCGCTCAT -> CGTCGCTCATC
GCGTGGGTCTT -> CGTGGGTCTTC
GCGTGTTAAAC -> CGTGTTAAACG
GCGTTGGGGGG -> CGTTGGGGGGA
GCGTTTCACGC -> CGTTTCACGCC
GCTAAGGCACC -> CTAAGGCACCG
GCTAATGAACA -> CTAATGAACAC
GCTACAGGCGA -> CTACAGGCGAG
GCTACCATCCC -> CTACCATCCCA
GCTACCCTATG -> CTACCCTATGT
GCTACGGCGTT -> CTACGGCGTTG
GCTAGAGCAAA -> CTAGAGCAAAT
GCTATAACAGA -> CTATAACAGAG
GCTCAAGCTGC -> CTCAAGCTGCA
GCTCAGAATCC -> CTCAGAATCCC
GCTCAGTGTGA -> CTCAGTGTGAC
GCTCATCCATG -> CTCATCCATGT
GCTCATCGGGC -> CTCATCGGGCT
GCTCCGGCACT -> CTCCGGCACTG
GCTCCTCCCAA -> CTCCTCCCAAG
GCTCCTTACTA -> CTCCTTACTAG
GCTCTGGATGT -> CTCTGGATGTT
GCTCTTGCCTA -> CTCTTGCCTAA
GCTGAAGATGA -> CTGAAGATGAA
GCTGATGGTGG -> CTGATGGTGGA
GCTGCAACTCA -> CTGCAACTCAG
GCTGCACTCTC -> CTGCACTCTCA
GCTGTAGCGTT -> CTGTAGCGTTT
GCTGTCTAAGT -> CTGTCTAAGTA
GCTGTCTGCGA -> CTGTCTGCGAT
GCTGTTCATGT -> CTGTTCATGTC
GCTGTTCGCTT -> CTGTTCGCTTT
GCTTAAGCCAA -> CTTAAGCCAAT
GCTTAGACCTA -> CTTAGACCTAG
GCTTCGTTTGC -> CTTCGTTTGCT
GCTTGAAGTCA -> CTTGAAGTCAG
GCTTGTAAGCA -> CTTGTAAGCAG
GCTTGTCTTAC -> CTTGTCTTACG
GCTTTCAACCC -> CTTTCAACCCC
GCTTTCATGAG -> CTTTCATGAGT
GGAAACATTGC -> GAAACATTGCT
GGAAATGGCTC -> GAAATGGCTCA
GGAAGAATGCT -> GAAGAATGCTC
GGAAGTAGTGG -> GAAGTAGTGGT
GGAATCTATCG -> GAATCTATCGT
GGACAACACCG -> GACAACACCGC
GGACAAGCCCA -> GACAAGCCCAT
GGACACCCACG -> GACACCCACGC
GGACATCTGAG -> GACATCTGAGT
GGACGCTACAG -> GACGCTACAGG
GGACGGGGCAA -> GACGGGGCAAC
GGACGTATAGT -> GACGTATAGTC
GGACTGGTTGG -> GACTGGTTGGC
GGAGCGCGATT -> GAGCGCGATTG
GGAGGCACGGT -> GAGGCACGGTG
GGAGGTACTTC -> GAGGTACTTCC
GGAGTACAGCC -> GAGTACAGCCA
GGAGTACCCGA -> GAGTACCCGAG
GGAGTGACTGA -> GAGTGACTGAG
GGATATATGAG -> GATATATGAGA
GGATCGAGTTA -> GATCGAGTTAG
GGATCTTTGTG -> GATCTTTGTGG
GGATGGATCTT -> GATGGATCTTT
GGATGTTGAAT -> GATGTTGAATT
GGATTTTACGG -> GATTTTACGGC
GGCAACCGTCC -> GCAACCGTCCG
GGCACCGTTAT -> GCACCGTTATC
GGCACGGTGTG -> GCACGGTGTGG
GGCACTAGCTG -> GCACTAGCTGA
GGCACTGCTCT -> GCACTGCTCTG
GGCACTTAACG -> GCACTTAACGG
GGCAGACCGTG -> GCAGACCGTGT
GGCAGCACTAA -> GCAGCACTAAT
GGCCAGCAAAG -> GCCAGCAAAGT
GGCCGACGGGC -> GCCGACGGGCC
GGCCGTTCCTC -> GCCGTTCCTCA
GGCCTAGCTTG -> GCCTAGCTTGT
GGCCTCTCATG -> GCCTCTCATGC
GGCGACAGGTC -> GCGACAGGTCA
GGCGAGGAAAT -> GCGAGGAAATG
GGCGAGTGCCC -> GCGAGTGCCCC
GGCGAGTTCAA -> GCGAGTTCAAC
GGCGATTTAAT -> GCGATTTAATT
GGCGTAGAGAT -> GCGTAGAGATG
GGCGTATTCTA -> GCGTATTCTAC
GGCGTTGGGGG -> GCGTTGGGGGG
GGCTACGGCGT -> GCTACGGCGTT
GGCTATAACAG -> GCTATAACAGA
GGCTCAGAATC -> GCTCAGAATCC
GGCTCATCCAT -> GCTCATCCATG
GGCTCCGGCAC -> GCTCCGGCACT
GGCTGTCTAAG -> GCTGTCTAAGT
GGCTGTTCATG -> GCTGTTCATGT
GGCTGTTCGCT -> GCTGTTCGCTT
GGCTTGTAAGC -> GCTTGTAAGCA
GGGAAACATTG -> GGAAACATTGC
GGGAAGAATGC -> GGAAGAATGCT
GGGAAGTAGTG -> GGAAGTAGTGG
GGGACATCTGA -> GGACATCTGAG
GGGAGTACAGC -> GGAGTACAGCC
GGGAGTGACTG -> GGAGTGACTGA
GGGCAACCGTC -> GGCAACCGTCC
GGGCCGACGGG -> GGCCGACGGGC
GGGCCGTTCCT -> GGCCGTTCCTC
GGGCGACAGGT -> GGCGACAGGTC
GGGCTCATCCA -> GGCTCATCCAT
GGGCTTGTAAG -> GGCTTGTAAGC
GGGGACATCTG -> GGGACATCTGA
GGGGAGTGACT -> GGGAGTGACTG
GGGGCAACCGT -> GGGCAACCGTC
GGGGCGACAGG -> GGGCGACAGGT
GGGGGAGTGAC -> GGGGAGTGACT
GGGGGGAGTGA -> GGGGGAGTGAC
GGGTAGCATCT -> GGTAGCATCTG
GGGTCGCGCAA -> GGTCGCGCAAG
GGGTCTTCACT -> GGTCTTCACTT
GGGTGATCCCA -> GGTGATCCCAA
GGGTTGTGCGC -> GGTTGTGCGCA
GGTACTTCCCG -> GTACTTCCCGC
GGTAGACCACT -> GTAGACCACTC
GGTAGCATCTG -> GTAGCATCTGG
GGTAGGACAAG -> GTAGGACAAGC
GGTCACCGGAT -> GTCACCGGATG
GGTCCACGGGA -> GTCCACGGGAA
GGTCCCCCCCC -> GTCCCCCCCCA
GGTCGAACACC -> GTCGAACACCC
GGTCGCGCAAG -> GTCGCGCAAGG
GGTCTGCACCA -> GTCTGCACCAA
GGTCTTCACTT -> GTCTTCACTTT
GGTGAGCGGAC -> GTGAGCGGACT
GGTGATCCCAA -> GTGATCCCAAA
GGTGGACGCTA -> GTGGACGCTAC
GGTGGACGTAT -> GTGGACGTATA
GGTGGAGGTAC -> GTGGAGGTACT
GGTGTGGCTCC -> GTGTGGCTCCG
GGTTAATAACT -> GTTAATAACTG
GGTTCAAAAAT -> GTTCAAAAATT
GGTTGGCGATT -> GTTGGCGATTT
GGTTGTGCGCA -> GTTGTGCGCAT
GGTTTAGTGCA -> GTTTAGTGCAG
GGTTTCTTTAC -> GTTTCTTTACC
GTAACCAGAAT -> TAACCAGAATG
GTAACCGTTCC -> TAACCGTTCCG
GTAAGCAGCAT -> TAAGCAGCATG
GTAATAATGTT -> TAATAATGTTG
GTAATACTGTG -> TAATACTGTGC
GTACAGCCAAC -> TACAGCCAACG
GTACCCAGACC -> TACCCAGACCA
GTACCCGAGTT -> TACCCGAGTTA
GTACGATTTGC -> TACGATTTGCG
GTACTTCCCGC -> TACTTCCCGCA
GTAGACCACTC -> TAGACCACTCA
GTAGAGATGCA -> TAGAGATGCAA
GTAGATGGTGG -> TAGATGGTGGA
GTAGCATCTGG -> TAGCATCTGGC
GTAGCCTTTAA -> TAGCCTTTAAA
GTAGCGTTTCA -> TAGCGTTTCAC
GTAGGACAAGC -> TAGGACAAGCC
GTAGTGGTCTG -> TAGTGGTCTGC
GTATAGTCGGG -> TATAGTCGGGA
GTATCGCCCAA -> TATCGCCCAAC
GTATTCTACGC -> TATTCTACGCC
GTATTGTGATC -> TATTGTGATCG
GTCAATGGTTA -> TCAATGGTTAA
GTCACCGGATG -> TCACCGGATGG
GTCAGCATTCG -> TCAGCATTCGC
GTCCAAATATA -> TCCAAATATAT
GTCCAATACCT -> TCCAATACCTC
GTCCACAATTC -> TCCACAATTCT
GTCCACGGGAA -> TCCACGGGAAG
GTCCCCCCCCA -> TCCCCCCCCAC
GTCCGTACCCA -> TCCGTACCCAG
GTCCTGACACG -> TCCTGACACGG
GTCGAACACCC -> TCGAACACCCC
GTCGATTTATT -> TCGATTTATTG
GTCGCGCAAGG -> TCGCGCAAGGA
GTCGCTCATCG -> TCGCTCATCGG
GTCGCTTAGAC -> TCGCTTAGACC
GTCGCTTGAAG -> TCGCTTGAAGT
GTCGGACACCC -> TCGGACACCCA
GTCGGATATAT -> TCGGATATATG
GTCGGGAAGTA -> TCGGGAAGTAG
GTCGGGGACAT -> TCGGGGACATC
GTCGTCGATTT -> TCGTCGATTTA
GTCTAAGTAAC -> TCTAAGTAACC
GTCTAGGAGCG -> TCTAGGAGCGC
GTCTGCACCAA -> TCTGCACCAAC
GTCTGCGATGT -> TCTGCGATGTT
GTCTTACGCCT -> TCTTACGCCTC
GTCTTCACTTT -> TCTTCACTTTC
GTGACCCTAAC -> TGACCCTAACC
GTGACTGAGGC -> TGACTGAGGCT
GTGAGCGGACT -> TGAGCGGACTG
GTGAGCTGATG -> TGAGCTGATGG
GTGATCCCAAA -> TGATCCCAAAC
GTGATCGATAC -> TGATCGATACG
GTGCAGCTTTC -> TGCAGCTTTCA
GTGCCAGGCAC -> TGCCAGGCACT
GTGCCCCGATA -> TGCCCCGATAA
GTGCCTCTCCG -> TGCCTCTCCGT
GTGCGCATTTG -> TGCGCATTTGC
GTGCGGTTCAA -> TGCGGTTCAAA
GTGCGTGGGTC -> TGCGTGGGTCT
GTGCTCAAGCT -> TGCTCAAGCTG
GTGCTCCTCCC -> TGCTCCTCCCA
GTGGACGCTAC -> TGGACGCTACA
GTGGACGTATA -> TGGACGTATAG
GTGGAGGTACT -> TGGAGGTACTT
GTGGATTTTAC -> TGGATTTTACG
GTGGCTCCGGC -> TGGCTCCGGCA
GTGGGTCTTCA -> TGGGTCTTCAC
GTGGGTTGTGC -> TGGGTTGTGCG
GTGGTCTGCAC -> TGGTCTGCACC
GTGGTGGAGGT -> TGGTGGAGGTA
GTGTACGATTT -> TGTACGATTTG
GTGTGACCCTA -> TGTGACCCTAA
GTGTGGCTCCG -> TGTGGCTCCGG
GTGTGTTGGGG -> TGTGTTGGGGC
GTGTTAAACGC -> TGTTAAACGCC
GTGTTCAGATT -> TGTTCAGATTT
GTGTTGGGGCG -> TGTTGGGGCGA
GTTAAACGCCG -> TTAAACGCCGG
GTTAAAGGGAG -> TTAAAGGGAGT
GTTAATAACTG -> TTAATAACTGG
GTTAGACAGTT -> TTAGACAGTTA
GTTAGATCGAA -> TTAGATCGAAA
GTTAGTAACCG -> TTAGTAACCGT
GTTAGTGGATT -> TTAGTGGATTT
GTTATCATCTC -> TTATCATCTCA
GTTATTGGTCG -> TTATTGGTCGA
GTTCAAAAATT -> TTCAAAAATTT
GTTCAACACAA -> TTCAACACAAA
GTTCAGATTTT -> TTCAGATTTTG
GTTCATGTCGG -> TTCATGTCGGA
GTTCCCCGCGC -> TTCCCCGCGCA
GTTCCGCGAGG -> TTCCGCGAGGC
GTTCCTCACCT -> TTCCTCACCTC
GTTCGCTTTCA -> TTCGCTTTCAA
GTTCGTCGTCG -> TTCGTCGTCGA
GTTGAATTAGA -> TTGAATTAGAT
GTTGGCGATTT -> TTGGCGATTTA
GTTGGGAAACA -> TTGGGAAACAT
GTTGGGGCGAC -> TTGGGGCGACA
GTTGGGGGGAG -> TTGGGGGGAGT
GTTGTGCGCAT -> TTGTGCGCATT
GTTTAGTGCAG -> TTTAGTGCAGC
GTTTCACGCCG -> TTTCACGCCGA
GTTTCTTTACC -> TTTCTTTACCA
GTTTGCTGCAC -> TTTGCTGCACT
GTTTGTTAAAG -> TTTGTTAAAGG
TAAAACCCTAG -> AAAACCCTAGA
TAAAAGCGCTT -> AAAAGCGCTTA
TAAACGCCGGC -> AAACGCCGGCT
TAAACTGCCAA -> AAACTGCCAAT
TAAAGGGAGTA -> AAAGGGAGTAC
TAAAGTGCGGT -> AAAGTGCGGTT
TAACAGAGCGC -> AACAGAGCGCG
TAACCAGAATG -> AACCAGAATGA
TAACCGTTCCG -> AACCGTTCCGC
TAACCTCACGG -> AACCTCACGGA
TAACGGCCTCT -> AACGGCCTCTC
TAACTGGAGTA -> AACTGGAGTAC
TAAGACAATTC -> AAGACAATTCC
TAAGCAGCATG -> AAGCAGCATGA
TAAGCCAATTC -> AAGCCAATTCT
TAAGGCACCGT -> AAGGCACCGTT
TAAGTAACCAG -> AAGTAACCAGA
TAATAACTGGA -> AATAACTGGAG
TAATAATGTTG -> AATAATGTTGG
TAATACTGTGC -> AATACTGTGCT
TAATCACTATC -> AATCACTATCC
TAATCCCCCTG -> AATCCCCCTGT
TAATGAACACG -> AATGAACACGA
TAATGTTGGGA -> AATGTTGGGAA
TAATTGTTATT -> AATTGTTATTG
TAATTTCAGCG -> AATTTCAGCGC
TACACCGATTC -> ACACCGATTCA
TACAGCCAACG -> ACAGCCAACGT
TACAGGCGAGT -> ACAGGCGAGTG
TACCAAGCACT -> ACCAAGCACTG
TACCATCCCAA -> ACCATCCCAAG
TACCCAGACCA -> ACCCAGACCAG
TACCCGAGTTA -> ACCCGAGTTAG
TACCCTATGTA -> ACCCTATGTAG
TACCTCGGCAC -> ACCTCGGCACT
TACGATAGTCC -> ACGATAGTCCA
TACGATTTGCG -> ACGATTTGCGC
TACGCCCCGAA -> ACGCCCCGAAG
TACGCCTCGCA -> ACGCCTCGCAC
TACGGCGTTGG -> ACGGCGTTGGG
TACGGCTGTCT -> ACGGCTGTCTA
TACTAGCATTA -> ACTAGCATTAC
TACTCGAGTCT -> ACTCGAGTCTA
TACTGACTGCT -> ACTGACTGCTT
TACTGCTAGAG -> ACTGCTAGAGC
TACTGTCAATG -> ACTGTCAATGG
TACTGTGCTCA -> ACTGTGCTCAA
TACTTCCCGCA -> ACTTCCCGCAG
TACTTTCCGAC -> ACTTTCCGACT
TAGACAGTTAG -> AGACAGTTAGT
TAGACCACTCA -> AGACCACTCAT
TAGACCTAGCT -> AGACCTAGCTC
TAGAGATGCAA -> AGAGATGCAAC
TAGAGCAAATC -> AGAGCAAATCC
TAGATAGTAAT -> AGATAGTAATA
TAGATCGAAAC -> AGATCGAAACT
TAGATCTCCCC -> AGATCTCCCCA
TAGATGGTGGA -> AGATGGTGGAC
TAGCATCTGGC -> AGCATCTGGCG
TAGCATTACTT -> AGCATTACTTT
TAGCCTTTAAA -> AGCCTTTAAAA
TAGCGTCGCTC -> AGCGTCGCTCA
TAGCGTTTCAC -> AGCGTTTCACG
TAGCTAAGGCA -> AGCTAAGGCAC
TAGCTAATGAA -> AGCTAATGAAC
TAGCTGAAGAT -> AGCTGAAGATG
TAGCTTGTCTT -> AGCTTGTCTTA
TAGGACAAGCC -> AGGACAAGCCC
TAGGACGGGGC -> AGGACGGGGCA
TAGGAGCGCGA -> AGGAGCGCGAT
TAGGGTGATCC -> AGGGTGATCCC
TAGTAACCGTT -> AGTAACCGTTC
TAGTAATAATG -> AGTAATAATGT
TAGTCCAAATA -> AGTCCAAATAT
TAGTCGGGAAG -> AGTCGGGAAGT
TAGTGCAGCTT -> AGTGCAGCTTT
TAGTGGATTTT -> AGTGGATTTTA
TAGTGGTCTGC -> AGTGGTCTGCA
TATAACAGAGC -> ATAACAGAGCG
TATAATTGTTA -> ATAATTGTTAT
TATAGCGTCGC -> ATAGCGTCGCT
TATAGTCGGGA -> ATAGTCGGGAA
TATATAATTGT -> ATATAATTGTT
TATATAGCGTC -> ATATAGCGTCG
TATATCCATCA -> ATATCCATCAT
TATATGAGAAT -> ATATGAGAATC
TATCATCTCAC -> ATCATCTCACT
TATCCATCATC -> ATCCATCATCA
TATCCCTGAGT -> ATCCCTGAGTG
TATCGCCCAAC -> ATCGCCCAACT
TATCGTGAGCT -> ATCGTGAGCTG
TATGAGAATCA -> ATGAGAATCAC
TATGTAGATGG -> ATGTAGATGGT
TATTAGGGTGA -> ATTAGGGTGAT
TATTATATAGC -> ATTATATAGCG
TATTCTACGCC -> ATTCTACGCCC
TATTGACGGCT -> ATTGACGGCTG
TATTGGTCGAA -> ATTGGTCGAAC
TATTGTGATCG -> ATTGTGATCGA
TCAAAAATTTG -> CAAAAATTTGC
TCAAATTCCAC -> CAAATTCCACT
TCAACACAAAG -> CAACACAAAGT
TCAACCCCCCG -> CAACCCCCCGA
TCAAGCTGCAA -> CAAGCTGCAAC
TCAATGGTTAA -> CAATGGTTAAT
TCACCCGGTTT -> CACCCGGTTTC
TCACCGGATGG -> CACCGGATGGA
TCACCTCGGCG -> CACCTCGGCGT
TCACCTGAGGG -> CACCTGAGGGC
TCACGCCGACG -> CACGCCGACGG
TCACGGAATCT -> CACGGAATCTA
TCACTATCCCT -> CACTATCCCTG
TCACTCCGCCG -> CACTCCGCCGA
TCACTTTCCCA -> CACTTTCCCAA
TCAGAAGGACA -> CAGAAGGACAA
TCAGAATCCCG -> CAGAATCCCGA
TCAGATTTTGG -> CAGATTTTGGT
TCAGCATTCGC -> CAGCATTCGCG
TCAGCGCCCAT -> CAGCGCCCATG
TCAGGTCCCCC -> CAGGTCCCCCC
TCAGTGTGACC -> CAGTGTGACCC
TCAGTTAGATC -> CAGTTAGATCG
TCATAAAAGCG -> CATAAAAGCGC
TCATCAAATTC -> CATCAAATTCC
TCATCCATGTA -> CATCCATGTAT
TCATCGGGCTC -> CATCGGGCTCA
TCATCTCACTC -> CATCTCACTCC
TCATGAGTGCT -> CATGAGTGCTC
TCATGCTACCC -> CATGCTACCCT
TCATGTCGGAT -> CATGTCGGATA
TCCAAATATAT -> CCAAATATATA
TCCAATACCTC -> CCAATACCTCG
TCCACAATTCT -> CCACAATTCTA
TCCACGGGAAG -> CCACGGGAAGA
TCCACTAGGAC -> CCACTAGGACG
TCCATCATCAA -> CCATCATCAAA
TCCATGTATCG -> CCATGTATCGC
TCCCAAACGGG -> CCCAAACGGGC
TCCCAACACGG -> CCCAACACGGC
TCCCAACCGCC -> CCCAACCGCCC
TCCCAAGCTCT -> CCCAAGCTCTT
TCCCAAGGCTA -> CCCAAGGCTAC
TCCCAGGGTCG -> CCCAGGGTCGC
TCCCCATTCGA -> CCCCATTCGAT
TCCCCCCCCAC -> CCCCCCCCACA
TCCCCCTGTCG -> CCCCCTGTCGC
TCCCCGCGCAA -> CCCCGCGCAAA
TCCCGATCGTC -> CCCGATCGTCC
TCCCGCAGGGT -> CCCGCAGGGTA
TCCCTGAGTGT -> CCCTGAGTGTG
TCCGACTTACA -> CCGACTTACAC
TCCGCCGAAGT -> CCGCCGAAGTG
TCCGCGAGGCA -> CCGCGAGGCAG
TCCGGCACTGC -> CCGGCACTGCT
TCCGTACCCAG -> CCGTACCCAGA
TCCGTTCGTCG -> CCGTTCGTCGT
TCCTACTGACT -> CCTACTGACTG
TCCTCACCTCG -> CCTCACCTCGG
TCCTCCCAAGG -> CCTCCCAAGGC
TCCTGACACGG -> CCTGACACGGT
TCCTGATAAAG -> CCTGATAAAGT
TCCTTACTAGC -> CCTTACTAGCA
TCGAAACTAGC -> CGAAACTAGCT
TCGAACACCCC -> CGAACACCCCG
TCGAAGTATTG -> CGAAGTATTGT
TCGAGTCTAGG -> CGAGTCTAGGA
TCGAGTTAGAC -> CGAGTTAGACA
TCGATACGATA -> CGATACGATAG
TCGATGAACAT -> CGATGAACATT
TCGATTTATTG -> CGATTTATTGA
TCGCACATCGC -> CGCACATCGCT
TCGCCCAACTA -> CGCCCAACTAT
TCGCGATTTCC -> CGCGATTTCCT
TCGCGCAAGGA -> CGCGCAAGGAT
TCGCGTGTTAA -> CGCGTGTTAAA
TCGCTACCATC -> CGCTACCATCC
TCGCTCATCGG -> CGCTCATCGGG
TCGCTTAGACC -> CGCTTAGACCT
TCGCTTGAAGT -> CGCTTGAAGTC
TCGCTTTCAAC -> CGCTTTCAACC
TCGGACACCCA -> CGGACACCCAC
TCGGATATATG -> CGGATATATGA
TCGGCACTAGC -> CGGCACTAGCT
TCGGCGTATTC -> CGGCGTATTCT
TCGGGAAGTAG -> CGGGAAGTAGT
TCGGGCTCATC -> CGGGCTCATCC
TCGGGGACATC -> CGGGGACATCT
TCGTCCTGACA -> CGTCCTGACAC
TCGTCGATTTA -> CGTCGATTTAT
TCGTCGTCGAT -> CGTCGTCGATT
TCGTGAGCTGA -> CGTGAGCTGAT
TCGTTTGCTGC -> CGTTTGCTGCA
TCTAAGTAACC -> CTAAGTAACCA
TCTACGCCCCG -> CTACGCCCCGA
TCTACTGCTAG -> CTACTGCTAGA
TCTAGGAGCGC -> CTAGGAGCGCG
TCTATCGTGAG -> CTATCGTGAGC
TCTATTAGGGT -> CTATTAGGGTG
TCTATTATATA -> CTATTATATAG
TCTCACTCCGC -> CTCACTCCGCC
TCTCAGGTCCC -> CTCAGGTCCCC
TCTCATGCTAC -> CTCATGCTACC
TCTCCCCATTC -> CTCCCCATTCG
TCTCCGTTCGT -> CTCCGTTCGTC
TCTGAGTAGCC -> CTGAGTAGCCT
TCTGCACCAAC -> CTGCACCAACA
TCTGCGATGTT -> CTGCGATGTTT
TCTGGATGTTG -> CTGGATGTTGA
TCTGGCGTAGA -> CTGGCGTAGAG
TCTTACGCCTC -> CTTACGCCTCG
TCTTCACTTTC -> CTTCACTTTCC
TCTTGCCTAAG -> CTTGCCTAAGA
TCTTTACCAAG -> CTTTACCAAGC
TCTTTGTGGGT -> CTTTGTGGGTT
TGAAAGAGAAT -> GAAAGAGAATG
TGAAATGCCAG -> GAAATGCCAGT
TGAACACGAAA -> GAACACGAAAC
TGAACATTCAG -> GAACATTCAGA
TGAACTGGCCA -> GAACTGGCCAG
TGAAGATGAAA -> GAAGATGAAAG
TGAAGTCAGCA -> GAAGTCAGCAT
TGAAGTCCACA -> GAAGTCCACAA
TGAATACTGTC -> GAATACTGTCA
TGAATTAGATA -> GAATTAGATAG
TGACACGGTCC -> GACACGGTCCA
TGACCCTAACC -> GACCCTAACCT
TGACCGCTCAG -> GACCGCTCAGT
TGACGGCTGTT -> GACGGCTGTTC
TGACTCTATTA -> GACTCTATTAT
TGACTGAGGCT -> GACTGAGGCTG
TGACTGCTTCG -> GACTGCTTCGT
TGAGAATCACC -> GAGAATCACCT
TGAGCGGACTG -> GAGCGGACTGG
TGAGCTGATGG -> GAGCTGATGGT
TGAGGCTGTTC -> GAGGCTGTTCG
TGAGGGCCGAC -> GAGGGCCGACG
TGAGTAGCCTT -> GAGTAGCCTTT
TGAGTGCTCCT -> GAGTGCTCCTC
TGAGTGTGTTG -> GAGTGTGTTGG
TGATAAAGTGC -> GATAAAGTGCG
TGATCCCAAAC -> GATCCCAAACG
TGATCGATACG -> GATCGATACGA
TGATGGTGGAC -> GATGGTGGACG
TGCAACCAGAC -> GCAACCAGACG
TGCAACTCAGT -> GCAACTCAGTT
TGCACCAACAC -> GCACCAACACC
TGCACTCTCAG -> GCACTCTCAGG
TGCAGCTTTCA -> GCAGCTTTCAT
TGCATGTAATA -> GCATGTAATAC
TGCCAATTGGC -> GCCAATTGGCG
TGCCAGGCACT -> GCCAGGCACTT
TGCCAGTCCAA -> GCCAGTCCAAT
TGCCCCGATAA -> GCCCCGATAAT
TGCCTAAGACA -> GCCTAAGACAA
TGCCTCTCCGT -> GCCTCTCCGTT
TGCGATGTTTG -> GCGATGTTTGT
TGCGCATTTGC -> GCGCATTTGCG
TGCGCCATCGC -> GCGCCATCGCG
TGCGGTAGGAC -> GCGGTAGGACA
TGCGGTTCAAA -> GCGGTTCAAAA
TGCGTGGGTCT -> GCGTGGGTCTT
TGCTACCCTAT -> GCTACCCTATG
TGCTAGAGCAA -> GCTAGAGCAAA
TGCTCAAGCTG -> GCTCAAGCTGC
TGCTCCTCCCA -> GCTCCTCCCAA
TGCTCCTTACT -> GCTCCTTACTA
TGCTCTGGATG -> GCTCTGGATGT
TGCTGCACTCT -> GCTGCACTCTC
TGCTGTAGCGT -> GCTGTAGCGTT
TGCTGTCTGCG -> GCTGTCTGCGA
TGCTTCGTTTG -> GCTTCGTTTGC
TGGACGCTACA -> GGACGCTACAG
TGGACGTATAG -> GGACGTATAGT
TGGAGGTACTT -> GGAGGTACTTC
TGGAGTACCCG -> GGAGTACCCGA
TGGATCTTTGT -> GGATCTTTGTG
TGGATGTTGAA -> GGATGTTGAAT
TGGATTTTACG -> GGATTTTACGG
TGGCCAGCAAA -> GGCCAGCAAAG
TGGCGAGGAAA -> GGCGAGGAAAT
TGGCGATTTAA -> GGCGATTTAAT
TGGCGTAGAGA -> GGCGTAGAGAT
TGGCTCAGAAT -> GGCTCAGAATC
TGGCTCCGGCA -> GGCTCCGGCAC
TGGGAAACATT -> GGGAAACATTG
TGGGGCGACAG -> GGGGCGACAGG
TGGGGGGAGTG -> GGGGGGAGTGA
TGGGTCTTCAC -> GGGTCTTCACT
TGGGTTGTGCG -> GGGTTGTGCGC
TGGTAGACCAC -> GGTAGACCACT
TGGTCGAACAC -> GGTCGAACACC
TGGTCTGCACC -> GGTCTGCACCA
TGGTGAGCGGA -> GGTGAGCGGAC
TGGTGGACGCT -> GGTGGACGCTA
TGGTGGACGTA -> GGTGGACGTAT
TGGTGGAGGTA -> GGTGGAGGTAC
TGGTTAATAAC -> GGTTAATAACT
TGGTTGGCGAT -> GGTTGGCGATT
TGTAAGCAGCA -> GTAAGCAGCAT
TGTAATACTGT -> GTAATACTGTG
TGTACGATTTG -> GTACGATTTGC
TGTAGATGGTG -> GTAGATGGTGG
TGTAGCGTTTC -> GTAGCGTTTCA
TGTATCGCCCA -> GTATCGCCCAA
TGTCAATGGTT -> GTCAATGGTTA
TGTCGCTTAGA -> GTCGCTTAGAC
TGTCGGATATA -> GTCGGATATAT
TGTCTAAGTAA -> GTCTAAGTAAC
TGTCTGCGATG -> GTCTGCGATGT
TGTCTTACGCC -> GTCTTACGCCT
TGTGACCCTAA -> GTGACCCTAAC
TGTGATCGATA -> GTGATCGATAC
TGTGCGCATTT -> GTGCGCATTTG
TGTGCTCAAGC -> GTGCTCAAGCT
TGTGGCTCCGG -> GTGGCTCCGGC
TGTGGGTTGTG -> GTGGGTTGTGC
TGTGTTGGGGC -> GTGTTGGGGCG
TGTTAAACGCC -> GTTAAACGCCG
TGTTAAAGGGA -> GTTAAAGGGAG
TGTTATTGGTC -> GTTATTGGTCG
TGTTCAGATTT -> GTTCAGATTTT
TGTTCATGTCG -> GTTCATGTCGG
TGTTCGCTTTC -> GTTCGCTTTCA
TGTTGAATTAG -> GTTGAATTAGA
TGTTGGGAAAC -> GTTGGGAAACA
TGTTGGGGCGA -> GTTGGGGCGAC
TGTTTGTTAAA -> GTTTGTTAAAG
TTAAAACCCTA -> TAAAACCCTAG
TTAAACGCCGG -> TAAACGCCGGC
TTAAACTGCCA -> TAAACTGCCAA
TTAAAGGGAGT -> TAAAGGGAGTA
TTAACGGCCTC -> TAACGGCCTCT
TTAAGCCAATT -> TAAGCCAATTC
TTAATAACTGG -> TAATAACTGGA
TTAATTTCAGC -> TAATTTCAGCG
TTACACCGATT -> TACACCGATTC
TTACCAAGCAC -> TACCAAGCACT
TTACGCCTCGC -> TACGCCTCGCA
TTACGGCTGTC -> TACGGCTGTCT
TTACTAGCATT -> TACTAGCATTA
TTACTCGAGTC -> TACTCGAGTCT
TTACTTTCCGA -> TACTTTCCGAC
TTAGACAGTTA -> TAGACAGTTAG
TTAGACCTAGC -> TAGACCTAGCT
TTAGATAGTAA -> TAGATAGTAAT
TTAGATCGAAA -> TAGATCGAAAC
TTAGCTAATGA -> TAGCTAATGAA
TTAGGGTGATC -> TAGGGTGATCC
TTAGTAACCGT -> TAGTAACCGTT
TTAGTGCAGCT -> TAGTGCAGCTT
TTAGTGGATTT -> TAGTGGATTTT
TTATATAGCGT -> TATATAGCGTC
TTATCATCTCA -> TATCATCTCAC
TTATTGACGGC -> TATTGACGGCT
TTATTGGTCGA -> TATTGGTCGAA
TTCAAAAATTT -> TCAAAAATTTG
TTCAACACAAA -> TCAACACAAAG
TTCAACCCCCC -> TCAACCCCCCG
TTCACCCGGTT -> TCACCCGGTTT
TTCACGCCGAC -> TCACGCCGACG
TTCACTTTCCC -> TCACTTTCCCA
TTCAGAAGGAC -> TCAGAAGGACA
TTCAGATTTTG -> TCAGATTTTGG
TTCAGCGCCCA -> TCAGCGCCCAT
TTCATGAGTGC -> TCATGAGTGCT
TTCATGTCGGA -> TCATGTCGGAT
TTCCACTAGGA -> TCCACTAGGAC
TTCCCAACACG -> TCCCAACACGG
TTCCCAACCGC -> TCCCAACCGCC
TTCCCCGCGCA -> TCCCCGCGCAA
TTCCCGCAGGG -> TCCCGCAGGGT
TTCCGACTTAC -> TCCGACTTACA
TTCCGCGAGGC -> TCCGCGAGGCA
TTCCTCACCTC -> TCCTCACCTCG
TTCCTGATAAA -> TCCTGATAAAG
TTCGATGAACA -> TCGATGAACAT
TTCGCGATTTC -> TCGCGATTTCC
TTCGCTTTCAA -> TCGCTTTCAAC
TTCGTCGTCGA -> TCGTCGTCGAT
TTCGTTTGCTG -> TCGTTTGCTGC
TTCTACGCCCC -> TCTACGCCCCG
TTCTACTGCTA -> TCTACTGCTAG
TTCTATTAGGG -> TCTATTAGGGT
TTCTTTACCAA -> TCTTTACCAAG
TTGAAGTCAGC -> TGAAGTCAGCA
TTGAATTAGAT -> TGAATTAGATA
TTGACCGCTCA -> TGACCGCTCAG
TTGACGGCTGT -> TGACGGCTGTT
TTGCCTAAGAC -> TGCCTAAGACA
TTGCGCCATCG -> TGCGCCATCGC
TTGCGGTAGGA -> TGCGGTAGGAC
TTGCTGCACTC -> TGCTGCACTCT
TTGCTGTAGCG -> TGCTGTAGCGT
TTGCTGTCTGC -> TGCTGTCTGCG
TTGGCGAGGAA -> TGGCGAGGAAA
TTGGCGATTTA -> TGGCGATTTAA
TTGGGAAACAT -> TGGGAAACATT
TTGGGGCGACA -> TGGGGCGACAG
TTGGGGGGAGT -> TGGGGGGAGTG
TTGGTCGAACA -> TGGTCGAACAC
TTGGTGAGCGG -> TGGTGAGCGGA
TTGTAAGCAGC -> TGTAAGCAGCA
TTGTCTTACGC -> TGTCTTACGCC
TTGTGATCGAT -> TGTGATCGATA
TTGTGCGCATT -> TGTGCGCATTT
TTGTGGGTTGT -> TGTGGGTTGTG
TTGTTAAAGGG -> TGTTAAAGGGA
TTGTTATTGGT -> TGTTATTGGTC
TTTAAAACCCT -> TTAAAACCCTA
TTTAAACTGCC -> TTAAACTGCCA
TTTAATTTCAG -> TTAATTTCAGC
TTTACCAAGCA -> TTACCAAGCAC
TTTACGGCTGT -> TTACGGCTGTC
TTTACTCGAGT -> TTACTCGAGTC
TTTAGTGCAGC -> TTAGTGCAGCT
TTTATTGACGG -> TTATTGACGGC
TTTCAACCCCC -> TTCAACCCCCC
TTTCACGCCGA -> TTCACGCCGAC
TTTCAGCGCCC -> TTCAGCGCCCA
TTTCATGAGTG -> TTCATGAGTGC
TTTCCCAACAC -> TTCCCAACACG
TTTCCGACTTA -> TTCCGACTTAC
TTTCCTGATAA -> TTCCTGATAAA
TTTCTTTACCA -> TTCTTTACCAA
TTTGCGCCATC -> TTGCGCCATCG
TTTGCGGTAGG -> TTGCGGTAGGA
TTTGCTGCACT -> TTGCTGCACTC
TTTGCTGTCTG -> TTGCTGTCTGC
TTTGGTGAGCG -> TTGGTGAGCGG
TTTGTGGGTTG -> TTGTGGGTTGT
TTTGTTAAAGG -> TTGTTAAAGGG
TTTTACGGCTG -> TTTACGGCTGT
TTTTGGTGAGC -> TTTGGTGAGCG
