AAAAAAGCTCC -> AAAAAGCTCCT
AAAAAGCTCCT -> AAAAGCTCCTC
AAAACAGCCTT -> AAACAGCCTTC
AAAACGAGGTA -> AAACGAGGTAT
AAAACGGCGCA -> AAACGGCGCAG
AAAAGAATAAC -> AAAGAATAACT
AAAAGCTCCTC -> AAAGCTCCTCC
AAAATAGAGGT -> AAATAGAGGTT
AAAATGGTGGA -> AAATGGTGGAC
AAAATTACTGC -> AAATTACTGCG
AAACAACTTGA -> AACAACTTGAG
AAACAGCCTTC -> AACAGCCTTCC
AAACGAGGTAT -> AACGAGGTATT
AAACGGCGCAG -> AACGGCGCAGG
AAACTGTGTGG -> AACTGTGTGGA
AAAGAATAACT -> AAGAATAACTG
AAAGACCCACA -> AAGACCCACAG
AAAGACTTCTA -> AAGACTTCTAG
AAAGAGATAAA -> AAGAGATAAAT
AAAGCCTAACT -> AAGCCTAACTC
AAAGCTCCTCC -> AAGCTCCTCCC
AAAGGGATATT -> AAGGGATATTG
AAAGTGGTCGC -> AAGTGGTCGCC
AAAGTTTCGAC -> AAGTTTCGACG
AAATACCAGGT -> AATACCAGGTC
AAATAGAGGTT -> AATAGAGGTTC
AAATAGTTGTG -> AATAGTTGTGT
AAATATACGGG -> AATATACGGGC
AAATCAAGGAC -> AATCAAGGACT
AAATCATCCTG -> AATCATCCTGA
AAATGGTGGAC -> AATGGTGGACC
AAATTACTGCG -> AATTACTGCGT
AACAAAAAAGC -> ACAAAAAAGCT
AACAAAATTAC -> ACAAAATTACT
AACAAATACCA -> ACAAATACCAG
AACAACTTGAG -> ACAACTTGAGG
AACACCAACTA -> ACACCAACTAT
AACAGAGGGGG -> ACAGAGGGGGG
AACAGCCTTCC -> ACAGCCTTCCG
AACATGTCGAT -> ACATGTCGATT
AACCCAACAGA -> ACCCAACAGAG
AACCGATAGGT -> ACCGATAGGTG
AACCTACGATC -> ACCTACGATCG
AACCTCCTGCA -> ACCTCCTGCAC
AACCTGGAAAA -> ACCTGGAAAAC
AACGAAGGCCT -> ACGAAGGCCTG
AACGAGGTATT -> ACGAGGTATTC
AACGCTGGGCA -> ACGCTGGGCAC
AACGGCGCAGG -> ACGGCGCAGGC
AACGGGGTTTT -> ACGGGGTTTTC
AACGTCACGTG -> ACGTCACGTGT
AACGTGCAATG -> ACGTGCAATGT
AACTATCCGGC -> ACTATCCGGCG
AACTATCGCTT -> ACTATCGCTTA
AACTATTCTTG -> ACTATTCTTGA
AACTCCCTCAG -> ACTCCCTCAGT
AACTGAGTTAC -> ACTGAGTTACA
AACTGCAAGGG -> ACTGCAAGGGA
AACTGCGCACC -> ACTGCGCACCC
AACTGTGTGGA -> ACTGTGTGGAT
AACTTATTTGT -> ACTTATTTGTC
AACTTGAGGTC -> ACTTGAGGTCC
AACTTGGCGTT -> ACTTGGCGTTC
AAGAACGCTGG -> AGAACGCTGGG
AAGAATAACTG -> AGAATAACTGC
AAGACCCACAG -> AGACCCACAGA
AAGACTTCTAG -> AGACTTCTAGG
AAGAGATAAAT -> AGAGATAAATC
AAGCAATAGCT -> AGCAATAGCTC
AAGCCTAACTC -> AGCCTAACTCC
AAGCCTGTACA -> AGCCTGTACAG
AAGCGCGATAT -> AGCGCGATATT
AAGCGGGGAGG -> AGCGGGGAGGT
AAGCTCCTCCC -> AGCTCCTCCCC
AAGGACTTATC -> AGGACTTATCG
AAGGCCAAAAT -> AGGCCAAAATA
AAGGCCGTAAG -> AGGCCGTAAGA
AAGGCCTGATA -> AGGCCTGATAG
AAGGGAGCGGA -> AGGGAGCGGAT
AAGGGATATTG -> AGGGATATTGC
AAGGGCGGACT -> AGGGCGGACTT
AAGGGTCAACT -> AGGGTCAACTA
AAGGTATAGAG -> AGGTATAGAGT
AAGTGCAGCAT -> AGTGCAGCATA
AAGTGGTCGCC -> AGTGGTCGCCG
AAGTTCATGCT -> AGTTCATGCTC
AAGTTCGATGT -> AGTTCGATGTT
AAGTTTAAAAT -> AGTTTAAAATG
AAGTTTCGACG -> AGTTTCGACGA
AATAACTGCGC -> ATAACTGCGCA
AATAAGGGCGG -> ATAAGGGCGGA
AATACAGATCG -> ATACAGATCGG
AATACCAGGTC -> ATACCAGGTCA
AATAGAAATAT -> ATAGAAATATA
AATAGAGCGGC -> ATAGAGCGGCG
AATAGAGGTTC -> ATAGAGGTTCA
AATAGCTCTAA -> ATAGCTCTAAC
AATAGTTGTGT -> ATAGTTGTGTG
AATATACGGGC -> ATATACGGGCG
AATCAAGGACT -> ATCAAGGACTT
AATCATCCTGA -> ATCATCCTGAG
AATCTGACACG -> ATCTGACACGC
AATGATTCAGT -> ATGATTCAGTG
AATGGGAGTCT -> ATGGGAGTCTC
AATGGGTCCCG -> ATGGGTCCCGC
AATGGTAGCAC -> ATGGTAGCACC
AATGGTGGACC -> ATGGTGGACCG
AATGTAATGTG -> ATGTAATGTGG
AATGTGGATCC -> ATGTGGATCCT
AATTACTATTG -> ATTACTATTGC
AATTACTGCGT -> ATTACTGCGTA
AATTCGCCCTA -> ATTCGCCCTAG
AATTGAGGGGG -> ATTGAGGGGGT
AATTGGATCCT -> ATTGGATCCTA
AATTGTATCGG -> ATTGTATCGGA
AATTTGTAAGT -> ATTTGTAAGTG
AATTTTCCTCA -> ATTTTCCTCAA
ACAAAAAAGCT -> CAAAAAAGCTC
ACAAAATTACT -> CAAAATTACTG
ACAAATACCAG -> CAAATACCAGG
ACAAATCAAGG -> CAAATCAAGGA
ACAACGTCACG -> CAACGTCACGT
ACAACTTGAGG -> CAACTTGAGGT
ACAAGGCCAAA -> CAAGGCCAAAA
ACAAGGTATAG -> CAAGGTATAGA
ACAATAAGGGC -> CAATAAGGGCG
ACAATTGAGGG -> CAATTGAGGGG
ACACCAACTAT -> CACCAACTATC
ACACGCGTCAG -> CACGCGTCAGA
ACACGTCGTGC -> CACGTCGTGCC
ACAGACTGTCG -> CAGACTGTCGG
ACAGAGGGGGG -> CAGAGGGGGGA
ACAGATCGGAG -> CAGATCGGAGT
ACAGCCAGAAC -> CAGCCAGAACG
ACAGCCTTCCG -> CAGCCTTCCGC
ACAGCTACCGG -> CAGCTACCGGA
ACAGCTTAGTT -> CAGCTTAGTTT
ACAGGTCCCAT -> CAGGTCCCATT
ACATAGACATT -> CATAGACATTA
ACATATTTGTG -> CATATTTGTGC
ACATGAGTATG -> CATGAGTATGC
ACATGTCGATT -> CATGTCGATTC
ACATGTTTGTT -> CATGTTTGTTT
ACATTACAGCC -> CATTACAGCCA
ACATTACCAGT -> CATTACCAGTT
ACATTGGCGGT -> CATTGGCGGTA
ACCAACTATCG -> CCAACTATCGC
ACCAATTTTCC -> CCAATTTTCCT
ACCACAATAAG -> CCACAATAAGG
ACCACACGTCG -> CCACACGTCGT
ACCAGGTCAAC -> CCAGGTCAACC
ACCAGTGGGGA -> CCAGTGGGGAG
ACCAGTTTAGA -> CCAGTTTAGAT
ACCCAACAGAG -> CCCAACAGAGG
ACCCACAGACT -> CCCACAGACTG
ACCCCCGCCAA -> CCCCCGCCAAC
ACCCGCAAAGA -> CCCGCAAAGAG
ACCCGTTCTGA -> CCCGTTCTGAC
ACCCTGTAGAA -> CCCTGTAGAAC
ACCGAACTGCA -> CCGAACTGCAA
ACCGAATAGAG -> CCGAATAGAGC
ACCGATAGGTG -> CCGATAGGTGA
ACCGCATTGAA -> CCGCATTGAAC
ACCGGACATGT -> CCGGACATGTT
ACCGGACGAGT -> CCGGACGAGTC
ACCGGTGCGAT -> CCGGTGCGATT
ACCTAATGGTA -> CCTAATGGTAG
ACCTACGATCG -> CCTACGATCGA
ACCTAGACTCT -> CCTAGACTCTA
ACCTCATCCTT -> CCTCATCCTTA
ACCTCCTGCAC -> CCTCCTGCACC
ACCTCGTGTGA -> CCTCGTGTGAA
ACCTGCAAAGT -> CCTGCAAAGTG
ACCTGGAAAAC -> CCTGGAAAACG
ACGAAACTGTG -> CGAAACTGTGT
ACGAAGGCCTG -> CGAAGGCCTGA
ACGACGGGCGC -> CGACGGGCGCC
ACGACGGTCGA -> CGACGGTCGAA
ACGACTGATGT -> CGACTGATGTG
ACGAGACCGGT -> CGAGACCGGTG
ACGAGACGTGC -> CGAGACGTGCG
ACGAGATTGTG -> CGAGATTGTGG
ACGAGGTATTC -> CGAGGTATTCC
ACGAGTCGAGA -> CGAGTCGAGAG
ACGATATGGTG -> CGATATGGTGG
ACGATCCGGCT -> CGATCCGGCTG
ACGATCGATAT -> CGATCGATATA
ACGCGACTGGT -> CGCGACTGGTG
ACGCGTCAGAC -> CGCGTCAGACT
ACGCTGGGCAC -> CGCTGGGCACG
ACGGCGCAGGC -> CGGCGCAGGCT
ACGGGCGCCGA -> CGGGCGCCGAA
ACGGGCGCGAA -> CGGGCGCGAAG
ACGGGCGCTTA -> CGGGCGCTTAC
ACGGGGTTTTC -> CGGGGTTTTCG
ACGGTCGAAAC -> CGGTCGAAACA
ACGGTCGATTC -> CGGTCGATTCG
ACGTCACGTGT -> CGTCACGTGTG
ACGTCGTGCCC -> CGTCGTGCCCT
ACGTGCAATGT -> CGTGCAATGTA
ACGTGCGCAGC -> CGTGCGCAGCG
ACGTGGGAATG -> CGTGGGAATGG
ACGTGTGACGA -> CGTGTGACGAA
ACTACTGAAAA -> CTACTGAAAAG
ACTATCCGGCG -> CTATCCGGCGG
ACTATCGCTTA -> CTATCGCTTAT
ACTATTCTTGA -> CTATTCTTGAA
ACTATTGCTAT -> CTATTGCTATG
ACTCCAGTAGG -> CTCCAGTAGGA
ACTCCCTCAGT -> CTCCCTCAGTA
ACTCCTTACCA -> CTCCTTACCAA
ACTCGGTTCGT -> CTCGGTTCGTA
ACTCTACCCTG -> CTCTACCCTGT
ACTCTTTCGAT -> CTCTTTCGATT
ACTGAAAAGAA -> CTGAAAAGAAT
ACTGAGTTACA -> CTGAGTTACAA
ACTGATGTGGC -> CTGATGTGGCT
ACTGCAAGGGA -> CTGCAAGGGAG
ACTGCGCACCC -> CTGCGCACCCG
ACTGCGTAATA -> CTGCGTAATAG
ACTGCGTGACC -> CTGCGTGACCT
ACTGGACATAT -> CTGGACATATT
ACTGGTGATTG -> CTGGTGATTGC
ACTGTCGGTCC -> CTGTCGGTCCT
ACTGTGTGGAT -> CTGTGTGGATG
ACTTAAAGGGA -> CTTAAAGGGAT
ACTTACAGCTT -> CTTACAGCTTA
ACTTACAGGTC -> CTTACAGGTCC
ACTTATCGTAT -> CTTATCGTATT
ACTTATTTGTC -> CTTATTTGTCT
ACTTCGACCCG -> CTTCGACCCGT
ACTTCTAGGGC -> CTTCTAGGGCA
ACTTGAGGTCC -> CTTGAGGTCCC
ACTTGGCGTTC -> CTTGGCGTTCC
ACTTTATAACA -> CTTTATAACAA
ACTTTTAATCT -> CTTTTAATCTG
AGAAAACGGCG -> GAAAACGGCGC
AGAAATATACG -> GAAATATACGG
AGAACCGATAG -> GAACCGATAGG
AGAACGCTGGG -> GAACGCTGGGC
AGAACGTGCAA -> GAACGTGCAAT
AGAAGCGGGGA -> GAAGCGGGGAG
AGAATAACTGC -> GAATAACTGCG
AGACATTACCA -> GACATTACCAG
AGACCCACAGA -> GACCCACAGAC
AGACCGGTGCG -> GACCGGTGCGA
AGACGTGCGCA -> GACGTGCGCAG
AGACTCTACCC -> GACTCTACCCT
AGACTGTCGGT -> GACTGTCGGTC
AGACTTACAGG -> GACTTACAGGT
AGACTTCTAGG -> GACTTCTAGGG
AGAGATAAATC -> GAGATAAATCA
AGAGCAATACA -> GAGCAATACAG
AGAGCGGCGCA -> GAGCGGCGCAT
AGAGGCCGTCG -> GAGGCCGTCGA
AGAGGGGGGAA -> GAGGGGGGAAC
AGAGGTTCAAG -> GAGGTTCAAGT
AGAGTCGGGTT -> GAGTCGGGTTC
AGATAAATCAT -> GATAAATCATC
AGATAAGCGCG -> GATAAGCGCGA
AGATCACAAGG -> GATCACAAGGC
AGATCGGAGTA -> GATCGGAGTAT
AGATTGTGGCA -> GATTGTGGCAC
AGCAATACAGA -> GCAATACAGAT
AGCAATAGCTC -> GCAATAGCTCT
AGCACCACAAT -> GCACCACAATA
AGCACTCGGTT -> GCACTCGGTTC
AGCATACGAGA -> GCATACGAGAT
AGCATCATTTT -> GCATCATTTTT
AGCCAGAACGT -> GCCAGAACGTG
AGCCGCGTGAT -> GCCGCGTGATT
AGCCTAACTCC -> GCCTAACTCCC
AGCCTCAGAAA -> GCCTCAGAAAA
AGCCTGTACAG -> GCCTGTACAGC
AGCCTTCCGCG -> GCCTTCCGCGA
AGCGCGATATT -> GCGCGATATTC
AGCGCTACCAC -> GCGCTACCACA
AGCGGACATGA -> GCGGACATGAG
AGCGGATGGCC -> GCGGATGGCCC
AGCGGCGCATA -> GCGGCGCATAC
AGCGGGGAGGT -> GCGGGGAGGTG
AGCTACCGGAC -> GCTACCGGACG
AGCTCCTCCCC -> GCTCCTCCCCT
AGCTCTAACTT -> GCTCTAACTTG
AGCTGCGGCAT -> GCTGCGGCATT
AGCTTAGTTTG -> GCTTAGTTTGC
AGGACATAGAC -> GGACATAGACA
AGGACATTACA -> GGACATTACAG
AGGACGTGGGA -> GGACGTGGGAA
AGGACTTATCG -> GGACTTATCGT
AGGCATTCTGT -> GGCATTCTGTC
AGGCCAAAATA -> GGCCAAAATAG
AGGCCGTAAGA -> GGCCGTAAGAA
AGGCCGTCGAG -> GGCCGTCGAGG
AGGCCTGATAG -> GGCCTGATAGG
AGGCTCACCTA -> GGCTCACCTAG
AGGGAGCGGAT -> GGGAGCGGATG
AGGGATATTGC -> GGGATATTGCA
AGGGCAGGTAA -> GGGCAGGTAAT
AGGGCGGACTT -> GGGCGGACTTA
AGGGGGGAACT -> GGGGGGAACTT
AGGGGGTCTGG -> GGGGGTCTGGG
AGGGGGTGGCA -> GGGGGTGGCAC
AGGGTCAACTA -> GGGTCAACTAT
AGGTAAGGCCG -> GGTAAGGCCGT
AGGTAATTCGC -> GGTAATTCGCC
AGGTATAGAGT -> GGTATAGAGTC
AGGTATTCCCC -> GGTATTCCCCC
AGGTCAACCTC -> GGTCAACCTCC
AGGTCCCATTT -> GGTCCCATTTC
AGGTCCCGATG -> GGTCCCGATGT
AGGTGACGAGA -> GGTGACGAGAC
AGGTGAGGCAT -> GGTGAGGCATT
AGGTTCAAGTT -> GGTTCAAGTTC
AGTAAATAGTT -> GTAAATAGTTG
AGTAAGGGTCA -> GTAAGGGTCAA
AGTAGGACATT -> GTAGGACATTA
AGTATCACTCC -> GTATCACTCCT
AGTATGCCTCC -> GTATGCCTCCA
AGTCACTTTTA -> GTCACTTTTAA
AGTCAGTTACC -> GTCAGTTACCG
AGTCGAGAGCA -> GTCGAGAGCAA
AGTCGCGATGT -> GTCGCGATGTA
AGTCGGGTTCT -> GTCGGGTTCTA
AGTCTCAGTTC -> GTCTCAGTTCC
AGTGATTAGCC -> GTGATTAGCCG
AGTGCAGCATA -> GTGCAGCATAC
AGTGCCGACCT -> GTGCCGACCTG
AGTGCCGAGCT -> GTGCCGAGCTG
AGTGGGGAGTG -> GTGGGGAGTGC
AGTGGTCGCCG -> GTGGTCGCCGT
AGTTACAATTG -> GTTACAATTGA
AGTTACCGGAC -> GTTACCGGACA
AGTTCATGCTC -> GTTCATGCTCC
AGTTCCCCTTA -> GTTCCCCTTAA
AGTTCGATGTT -> GTTCGATGTTG
AGTTGTGTGCA -> GTTGTGTGCAC
AGTTTAAAATG -> GTTTAAAATGG
AGTTTAGATAA -> GTTTAGATAAG
AGTTTCGACGA -> GTTTCGACGAT
AGTTTGCAACC -> GTTTGCAACCT
ATAAATCATCC -> TAAATCATCCT
ATAACAAATAC -> TAACAAATACC
ATAACCTACGA -> TAACCTACGAT
ATAACGAAGGC -> TAACGAAGGCC
ATAACTGAGTT -> TAACTGAGTTA
ATAACTGCGCA -> TAACTGCGCAC
ATAAGCGCGAT -> TAAGCGCGATA
ATAAGGGCGGA -> TAAGGGCGGAC
ATACAAATCAA -> TACAAATCAAG
ATACAAGGTAT -> TACAAGGTATA
ATACAGATCGG -> TACAGATCGGA
ATACATTGGCG -> TACATTGGCGG
ATACCAGGTCA -> TACCAGGTCAA
ATACGAGATTG -> TACGAGATTGT
ATACGGGCGCG -> TACGGGCGCGA
ATACGGGCGCT -> TACGGGCGCTT
ATAGAAATATA -> TAGAAATATAC
ATAGACATTAC -> TAGACATTACC
ATAGAGCGGCG -> TAGAGCGGCGC
ATAGAGGTTCA -> TAGAGGTTCAA
ATAGAGTCGGG -> TAGAGTCGGGT
ATAGCCTCAGA -> TAGCCTCAGAA
ATAGCTCTAAC -> TAGCTCTAACT
ATAGGACGTGG -> TAGGACGTGGG
ATAGGTGACGA -> TAGGTGACGAG
ATAGTAAATAG -> TAGTAAATAGT
ATAGTCGCGAT -> TAGTCGCGATG
ATAGTTGTGTG -> TAGTTGTGTGC
ATATAACGAAG -> TATAACGAAGG
ATATACGGGCG -> TATACGGGCGC
ATATGGTGGGT -> TATGGTGGGTA
ATATTCTGGAT -> TATTCTGGATG
ATATTGCAGTC -> TATTGCAGTCA
ATATTTGTGCC -> TATTTGTGCCG
ATCAAGGACTT -> TCAAGGACTTA
ATCACAAGGCC -> TCACAAGGCCA
ATCACTCCTTA -> TCACTCCTTAC
ATCAGGGGGTC -> TCAGGGGGTCT
ATCATCCTGAG -> TCATCCTGAGA
ATCATTTTTTC -> TCATTTTTTCA
ATCCAGATCAC -> TCCAGATCACA
ATCCCCACCTC -> TCCCCACCTCA
ATCCGGCGGGT -> TCCGGCGGGTT
ATCCGGCTGGT -> TCCGGCTGGTC
ATCCTACTGCG -> TCCTACTGCGT
ATCCTCCTCTG -> TCCTCCTCTGT
ATCCTGAGAAG -> TCCTGAGAAGC
ATCCTTATAGT -> TCCTTATAGTC
ATCCTTCGCTC -> TCCTTCGCTCT
ATCGATATAAC -> TCGATATAACG
ATCGCTTATAG -> TCGCTTATAGC
ATCGGACACAT -> TCGGACACATC
ATCGGAGTATC -> TCGGAGTATCA
ATCGTATAACC -> TCGTATAACCT
ATCGTATTATT -> TCGTATTATTA
ATCTGACACGC -> TCTGACACGCG
ATGAGTATGCC -> TGAGTATGCCT
ATGATACAAGG -> TGATACAAGGT
ATGATTCAGTG -> TGATTCAGTGC
ATGCCTCCAAT -> TGCCTCCAATG
ATGCTACGACT -> TGCTACGACTG
ATGCTCCACTT -> TGCTCCACTTC
ATGGAGCATCA -> TGGAGCATCAT
ATGGCCCTTGC -> TGGCCCTTGCT
ATGGCTGATGA -> TGGCTGATGAT
ATGGGAGTCTC -> TGGGAGTCTCA
ATGGGTCCCGC -> TGGGTCCCGCG
ATGGTAGCACC -> TGGTAGCACCA
ATGGTGGACCG -> TGGTGGACCGA
ATGGTGGGTAT -> TGGTGGGTATG
ATGTAATGTGG -> TGTAATGTGGA
ATGTATCAGGG -> TGTATCAGGGG
ATGTATCCTCC -> TGTATCCTCCT
ATGTCCGTAAT -> TGTCCGTAATT
ATGTCGATTCC -> TGTCGATTCCA
ATGTGGATCCT -> TGTGGATCCTT
ATGTGGCTTCT -> TGTGGCTTCTG
ATGTTCTCTGC -> TGTTCTCTGCA
ATGTTGTCTTT -> TGTTGTCTTTT
ATGTTTGTTTC -> TGTTTGTTTCA
ATTAAAGACCC -> TTAAAGACCCA
ATTACAGCCAG -> TTACAGCCAGA
ATTACCAGTTT -> TTACCAGTTTA
ATTACTATTGC -> TTACTATTGCT
ATTACTGCGTA -> TTACTGCGTAA
ATTAGCCGCGT -> TTAGCCGCGTG
ATTAGCGCTAC -> TTAGCGCTACC
ATTATTAGCGC -> TTATTAGCGCT
ATTCAGTGCCG -> TTCAGTGCCGA
ATTCCATCCAG -> TTCCATCCAGA
ATTCCCCCCGC -> TTCCCCCCGCT
ATTCGCCCTAG -> TTCGCCCTAGT
ATTCGTAACAA -> TTCGTAACAAA
ATTCTCCCTAC -> TTCTCCCTACC
ATTCTGGATGT -> TTCTGGATGTC
ATTCTGTCCAA -> TTCTGTCCAAC
ATTCTTGAAGC -> TTCTTGAAGCA
ATTGAACTATT -> TTGAACTATTC
ATTGACTCCAG -> TTGACTCCAGT
ATTGAGGGGGT -> TTGAGGGGGTG
ATTGATTCTCC -> TTGATTCTCCC
ATTGCAGTCAG -> TTGCAGTCAGT
ATTGCATTAAA -> TTGCATTAAAG
ATTGCTATGGA -> TTGCTATGGAG
ATTGCTCAATT -> TTGCTCAATTA
ATTGGATCCTA -> TTGGATCCTAC
ATTGGCGACGA -> TTGGCGACGAC
ATTGGCGGTAC -> TTGGCGGTACG
ATTGTATCGGA -> TTGTATCGGAC
ATTGTGGCACC -> TTGTGGCACCG
ATTTAATGATT -> TTTAATGATTC
ATTTCATCCCC -> TTTCATCCCCA
ATTTCCGCCGT -> TTTCCGCCGTA
ATTTGTAAGTG -> TTTGTAAGTGC
ATTTGTCTCTC -> TTTGTCTCTCT
ATTTGTGCCGC -> TTTGTGCCGCG
ATTTTCCTCAA -> TTTTCCTCAAC
ATTTTTTCAAA -> TTTTTTCAAAG
CAAAAAAGCTC -> AAAAAAGCTCC
CAAAATAGAGG -> AAAATAGAGGT
CAAAATTACTG -> AAAATTACTGC
CAAAGAGATAA -> AAAGAGATAAA
CAAAGCCTAAC -> AAAGCCTAACT
CAAAGTGGTCG -> AAAGTGGTCGC
CAAATACCAGG -> AAATACCAGGT
CAAATCAAGGA -> AAATCAAGGAC
CAACAAAAAAG -> AACAAAAAAGC
CAACACCAACT -> AACACCAACTA
CAACAGAGGGG -> AACAGAGGGGG
CAACATGTCGA -> AACATGTCGAT
CAACCCAACAG -> AACCCAACAGA
CAACCTCCTGC -> AACCTCCTGCA
CAACCTGGAAA -> AACCTGGAAAA
CAACGTCACGT -> AACGTCACGTG
CAACTATCCGG -> AACTATCCGGC
CAACTATCGCT -> AACTATCGCTT
CAACTTGAGGT -> AACTTGAGGTC
CAAGGACTTAT -> AAGGACTTATC
CAAGGCCAAAA -> AAGGCCAAAAT
CAAGGGAGCGG -> AAGGGAGCGGA
CAAGGTATAGA -> AAGGTATAGAG
CAAGTTCGATG -> AAGTTCGATGT
CAATAAGGGCG -> AATAAGGGCGG
CAATACAGATC -> AATACAGATCG
CAATAGCTCTA -> AATAGCTCTAA
CAATGGGTCCC -> AATGGGTCCCG
CAATGTAATGT -> AATGTAATGTG
CAATTACTATT -> AATTACTATTG
CAATTGAGGGG -> AATTGAGGGGG
CAATTTTCCTC -> AATTTTCCTCA
CACAAGGCCAA -> ACAAGGCCAAA
CACAATAAGGG -> ACAATAAGGGC
CACACGTCGTG -> ACACGTCGTGC
CACAGACTGTC -> ACAGACTGTCG
CACCAACTATC -> ACCAACTATCG
CACCACAATAA -> ACCACAATAAG
CACCAGTGGGG -> ACCAGTGGGGA
CACCCCCGCCA -> ACCCCCGCCAA
CACCCGCAAAG -> ACCCGCAAAGA
CACCGCATTGA -> ACCGCATTGAA
CACCTAGACTC -> ACCTAGACTCT
CACCTCATCCT -> ACCTCATCCTT
CACCTCGTGTG -> ACCTCGTGTGA
CACGAGACGTG -> ACGAGACGTGC
CACGATCCGGC -> ACGATCCGGCT
CACGCGACTGG -> ACGCGACTGGT
CACGCGTCAGA -> ACGCGTCAGAC
CACGTCGTGCC -> ACGTCGTGCCC
CACGTGTGACG -> ACGTGTGACGA
CACTACTGAAA -> ACTACTGAAAA
CACTCCTTACC -> ACTCCTTACCA
CACTCGGTTCG -> ACTCGGTTCGT
CACTTCGACCC -> ACTTCGACCCG
CACTTTATAAC -> ACTTTATAACA
CACTTTTAATC -> ACTTTTAATCT
CAGAAAACGGC -> AGAAAACGGCG
CAGAACGTGCA -> AGAACGTGCAA
CAGACTGTCGG -> AGACTGTCGGT
CAGACTTACAG -> AGACTTACAGG
CAGAGGGGGGA -> AGAGGGGGGAA
CAGATCACAAG -> AGATCACAAGG
CAGATCGGAGT -> AGATCGGAGTA
CAGCATACGAG -> AGCATACGAGA
CAGCCAGAACG -> AGCCAGAACGT
CAGCCTTCCGC -> AGCCTTCCGCG
CAGCGGACATG -> AGCGGACATGA
CAGCTACCGGA -> AGCTACCGGAC
CAGCTTAGTTT -> AGCTTAGTTTG
CAGGCTCACCT -> AGGCTCACCTA
CAGGGGGTCTG -> AGGGGGTCTGG
CAGGTAATTCG -> AGGTAATTCGC
CAGGTCAACCT -> AGGTCAACCTC
CAGGTCCCATT -> AGGTCCCATTT
CAGTAAGGGTC -> AGTAAGGGTCA
CAGTAGGACAT -> AGTAGGACATT
CAGTCAGTTAC -> AGTCAGTTACC
CAGTGCCGACC -> AGTGCCGACCT
CAGTGGGGAGT -> AGTGGGGAGTG
CAGTTACCGGA -> AGTTACCGGAC
CAGTTCCCCTT -> AGTTCCCCTTA
CAGTTTAGATA -> AGTTTAGATAA
CATAACTGAGT -> ATAACTGAGTT
CATACAAATCA -> ATACAAATCAA
CATACGAGATT -> ATACGAGATTG
CATAGACATTA -> ATAGACATTAC
CATATTTGTGC -> ATATTTGTGCC
CATCATTTTTT -> ATCATTTTTTC
CATCCAGATCA -> ATCCAGATCAC
CATCCCCACCT -> ATCCCCACCTC
CATCCTGAGAA -> ATCCTGAGAAG
CATCCTTATAG -> ATCCTTATAGT
CATCGTATAAC -> ATCGTATAACC
CATGAGTATGC -> ATGAGTATGCC
CATGCTCCACT -> ATGCTCCACTT
CATGTCGATTC -> ATGTCGATTCC
CATGTTTGTTT -> ATGTTTGTTTC
CATTAAAGACC -> ATTAAAGACCC
CATTACAGCCA -> ATTACAGCCAG
CATTACCAGTT -> ATTACCAGTTT
CATTCTGTCCA -> ATTCTGTCCAA
CATTGAACTAT -> ATTGAACTATT
CATTGATTCTC -> ATTGATTCTCC
CATTGGCGGTA -> ATTGGCGGTAC
CATTTAATGAT -> ATTTAATGATT
CATTTCCGCCG -> ATTTCCGCCGT
CATTTTTTCAA -> ATTTTTTCAAA
CCAAAATAGAG -> CAAAATAGAGG
CCAACAGAGGG -> CAACAGAGGGG
CCAACATGTCG -> CAACATGTCGA
CCAACCCAACA -> CAACCCAACAG
CCAACTATCGC -> CAACTATCGCT
CCAATGGGTCC -> CAATGGGTCCC
CCAATTTTCCT -> CAATTTTCCTC
CCACAATAAGG -> CACAATAAGGG
CCACACGTCGT -> CACACGTCGTG
CCACAGACTGT -> CACAGACTGTC
CCACCTCATCC -> CACCTCATCCT
CCACTACTGAA -> CACTACTGAAA
CCACTTCGACC -> CACTTCGACCC
CCACTTTATAA -> CACTTTATAAC
CCAGAACGTGC -> CAGAACGTGCA
CCAGATCACAA -> CAGATCACAAG
CCAGGTCAACC -> CAGGTCAACCT
CCAGTAGGACA -> CAGTAGGACAT
CCAGTGGGGAG -> CAGTGGGGAGT
CCAGTTTAGAT -> CAGTTTAGATA
CCATAACTGAG -> CATAACTGAGT
CCATCCAGATC -> CATCCAGATCA
CCATTTCCGCC -> CATTTCCGCCG
CCCAACAGAGG -> CCAACAGAGGG
CCCACAGACTG -> CCACAGACTGT
CCCACCTCATC -> CCACCTCATCC
CCCATTTCCGC -> CCATTTCCGCC
CCCCACCTCAT -> CCCACCTCATC
CCCCCCGCTCC -> CCCCCGCTCCA
CCCCCGCCAAC -> CCCCGCCAACA
CCCCCGCTCCA -> CCCCGCTCCAT
CCCCGCCAACA -> CCCGCCAACAT
CCCCGCTCCAT -> CCCGCTCCATA
CCCCTATAGTA -> CCCTATAGTAA
CCCCTTAAGTT -> CCCTTAAGTTC
CCCGATGTTCT -> CCGATGTTCTC
CCCGCAAAGAG -> CCGCAAAGAGA
CCCGCCAACAT -> CCGCCAACATG
CCCGCGCCTGT -> CCGCGCCTGTC
CCCGCTCCATA -> CCGCTCCATAA
CCCGTTCTGAC -> CCGTTCTGACT
CCCTACCGAAT -> CCTACCGAATA
CCCTAGTCACT -> CCTAGTCACTT
CCCTATAGTAA -> CCTATAGTAAA
CCCTCACGCGA -> CCTCACGCGAC
CCCTCAGTAAG -> CCTCAGTAAGG
CCCTGTAGAAC -> CCTGTAGAACC
CCCTTAAGTTC -> CCTTAAGTTCA
CCCTTGCTAAT -> CCTTGCTAATT
CCGAAAGTTTC -> CGAAAGTTTCG
CCGAACTGCAA -> CGAACTGCAAG
CCGAATAGAGC -> CGAATAGAGCG
CCGACCTGCAA -> CGACCTGCAAA
CCGAGCTGCGG -> CGAGCTGCGGC
CCGATAGGTGA -> CGATAGGTGAC
CCGATGTTCTC -> CGATGTTCTCT
CCGCAAAGAGA -> CGCAAAGAGAT
CCGCATTGAAC -> CGCATTGAACT
CCGCCAACATG -> CGCCAACATGT
CCGCCGTACAA -> CGCCGTACAAC
CCGCGATTGAC -> CGCGATTGACT
CCGCGCCTGTC -> CGCGCCTGTCG
CCGCGTGATTG -> CGCGTGATTGG
CCGCGTTAGAG -> CGCGTTAGAGG
CCGCTCCATAA -> CGCTCCATAAC
CCGGACATGTT -> CGGACATGTTT
CCGGACGAGTC -> CGGACGAGTCG
CCGGCGGGTTA -> CGGCGGGTTAT
CCGGCTGGTCA -> CGGCTGGTCAA
CCGGTGCGATT -> CGGTGCGATTT
CCGTAAGAACG -> CGTAAGAACGC
CCGTAATTGTA -> CGTAATTGTAT
CCGTACAACGT -> CGTACAACGTC
CCGTCGAGGTA -> CGTCGAGGTAA
CCGTGATACAT -> CGTGATACATT
CCGTTCTGACT -> CGTTCTGACTC
CCTAACTCCCT -> CTAACTCCCTC
CCTAATGGTAG -> CTAATGGTAGC
CCTACCGAATA -> CTACCGAATAG
CCTACGATCGA -> CTACGATCGAT
CCTACTGCGTG -> CTACTGCGTGA
CCTAGACTCTA -> CTAGACTCTAC
CCTAGCACTCG -> CTAGCACTCGG
CCTAGTCACTT -> CTAGTCACTTT
CCTATAGTAAA -> CTATAGTAAAT
CCTCAACACCA -> CTCAACACCAA
CCTCACGCGAC -> CTCACGCGACT
CCTCAGAAAAC -> CTCAGAAAACG
CCTCAGTAAGG -> CTCAGTAAGGG
CCTCATCCTTA -> CTCATCCTTAT
CCTCCAATGGG -> CTCCAATGGGT
CCTCCCCTATA -> CTCCCCTATAG
CCTCCTCTGTG -> CTCCTCTGTGA
CCTCCTGCACC -> CTCCTGCACCA
CCTCGTGTGAA -> CTCGTGTGAAT
CCTCTGTGAAG -> CTCTGTGAAGT
CCTGAGAAGCG -> CTGAGAAGCGG
CCTGATAGGAC -> CTGATAGGACG
CCTGCAAAGTG -> CTGCAAAGTGG
CCTGCACCAGT -> CTGCACCAGTG
CCTGGAAAACG -> CTGGAAAACGA
CCTGTACAGCT -> CTGTACAGCTA
CCTGTAGAACC -> CTGTAGAACCG
CCTGTCGGCGT -> CTGTCGGCGTC
CCTTAAGTTCA -> CTTAAGTTCAT
CCTTACCAATT -> CTTACCAATTT
CCTTAGTGATT -> CTTAGTGATTA
CCTTATAGTCG -> CTTATAGTCGC
CCTTCCGCGAT -> CTTCCGCGATT
CCTTCGCTCTG -> CTTCGCTCTGA
CCTTGCTAATT -> CTTGCTAATTG
CGAAACAACTT -> GAAACAACTTG
CGAAACTGTGT -> GAAACTGTGTG
CGAAAGTTTCG -> GAAAGTTTCGA
CGAACTGCAAG -> GAACTGCAAGG
CGAAGCCTGTA -> GAAGCCTGTAC
CGAAGGCCTGA -> GAAGGCCTGAT
CGAATAGAGCG -> GAATAGAGCGG
CGACCCGTTCT -> GACCCGTTCTG
CGACCTGCAAA -> GACCTGCAAAG
CGACGACGGGC -> GACGACGGGCG
CGACGATATGG -> GACGATATGGT
CGACGGGCGCC -> GACGGGCGCCG
CGACGGTCGAA -> GACGGTCGAAA
CGACTGATGTG -> GACTGATGTGG
CGACTGGTGAT -> GACTGGTGATT
CGAGACCGGTG -> GAGACCGGTGC
CGAGACGTGCG -> GAGACGTGCGC
CGAGAGCAATA -> GAGAGCAATAC
CGAGATTGTGG -> GAGATTGTGGC
CGAGCTGCGGC -> GAGCTGCGGCA
CGAGGTAAGGC -> GAGGTAAGGCC
CGAGGTATTCC -> GAGGTATTCCC
CGAGTCGAGAG -> GAGTCGAGAGC
CGATAGGTGAC -> GATAGGTGACG
CGATATAACGA -> GATATAACGAA
CGATATGGTGG -> GATATGGTGGG
CGATATTCTGG -> GATATTCTGGA
CGATCCGGCTG -> GATCCGGCTGG
CGATCGATATA -> GATCGATATAA
CGATGTATCCT -> GATGTATCCTC
CGATGTTCTCT -> GATGTTCTCTG
CGATGTTGTCT -> GATGTTGTCTT
CGATTCCATCC -> GATTCCATCCA
CGATTCGTAAC -> GATTCGTAACA
CGATTGACTCC -> GATTGACTCCA
CGATTGCATTA -> GATTGCATTAA
CGATTTCATCC -> GATTTCATCCC
CGCAAAGAGAT -> GCAAAGAGATA
CGCACCCGCAA -> GCACCCGCAAA
CGCAGCGGACA -> GCAGCGGACAT
CGCAGGCTCAC -> GCAGGCTCACC
CGCATACAAAT -> GCATACAAATC
CGCATTGAACT -> GCATTGAACTA
CGCATTGATTC -> GCATTGATTCT
CGCCAACATGT -> GCCAACATGTC
CGCCCTAGTCA -> GCCCTAGTCAC
CGCCGAAAGTT -> GCCGAAAGTTT
CGCCGTACAAC -> GCCGTACAACG
CGCCGTGATAC -> GCCGTGATACA
CGCCTGTCGGC -> GCCTGTCGGCG
CGCGAAGCCTG -> GCGAAGCCTGT
CGCGACTGGTG -> GCGACTGGTGA
CGCGATATTCT -> GCGATATTCTG
CGCGATGTATC -> GCGATGTATCC
CGCGATTGACT -> GCGATTGACTC
CGCGCCTGTCG -> GCGCCTGTCGG
CGCGTCAGACT -> GCGTCAGACTT
CGCGTGATTGG -> GCGTGATTGGC
CGCGTTAGAGG -> GCGTTAGAGGC
CGCTACCACAC -> GCTACCACACG
CGCTCCATAAC -> GCTCCATAACT
CGCTCTGACTG -> GCTCTGACTGG
CGCTGGGCACG -> GCTGGGCACGA
CGCTTACTTAC -> GCTTACTTACA
CGCTTATAGCC -> GCTTATAGCCT
CGGAACGGGGT -> GGAACGGGGTT
CGGACACATCT -> GGACACATCTC
CGGACATGAGT -> GGACATGAGTA
CGGACATGTTT -> GGACATGTTTG
CGGACGAGTCG -> GGACGAGTCGA
CGGACTTAAAG -> GGACTTAAAGG
CGGAGTATCAC -> GGAGTATCACT
CGGATGGCCCT -> GGATGGCCCTT
CGGCATTTAAT -> GGCATTTAATG
CGGCGCAGGCT -> GGCGCAGGCTC
CGGCGCATACA -> GGCGCATACAA
CGGCGGGTTAT -> GGCGGGTTATG
CGGCGTCGGAA -> GGCGTCGGAAC
CGGCTGGTCAA -> GGCTGGTCAAC
CGGGCGCCGAA -> GGGCGCCGAAA
CGGGCGCGAAG -> GGGCGCGAAGC
CGGGCGCTTAC -> GGGCGCTTACT
CGGGGAGGTGA -> GGGGAGGTGAG
CGGGGTTTTCG -> GGGGTTTTCGC
CGGGTTATGTA -> GGGTTATGTAT
CGGGTTCTATA -> GGGTTCTATAC
CGGTACGACGG -> GGTACGACGGT
CGGTCCTAGCA -> GGTCCTAGCAC
CGGTCGAAACA -> GGTCGAAACAA
CGGTCGATTCG -> GGTCGATTCGT
CGGTGCGATTT -> GGTGCGATTTC
CGGTTCGTAAA -> GGTTCGTAAAG
CGTAAAGACTT -> GTAAAGACTTC
CGTAACAAAAT -> GTAACAAAATT
CGTAAGAACGC -> GTAAGAACGCT
CGTAATAGAAA -> GTAATAGAAAT
CGTAATTGTAT -> GTAATTGTATC
CGTACAACGTC -> GTACAACGTCA
CGTATAACCTA -> GTATAACCTAC
CGTATTATTAG -> GTATTATTAGC
CGTCACGTGTG -> GTCACGTGTGA
CGTCAGACTTA -> GTCAGACTTAC
CGTCGAGGTAA -> GTCGAGGTAAG
CGTCGGAACGG -> GTCGGAACGGG
CGTCGTGCCCT -> GTCGTGCCCTC
CGTGACCTAAT -> GTGACCTAATG
CGTGATACATT -> GTGATACATTG
CGTGATTGGCG -> GTGATTGGCGA
CGTGCAATGTA -> GTGCAATGTAA
CGTGCCCTCAC -> GTGCCCTCACG
CGTGCGCAGCG -> GTGCGCAGCGG
CGTGGGAATGG -> GTGGGAATGGG
CGTGTGAATTT -> GTGTGAATTTG
CGTGTGACGAA -> GTGTGACGAAA
CGTTAGAGGCC -> GTTAGAGGCCG
CGTTCCTTAGT -> GTTCCTTAGTG
CGTTCTGACTC -> GTTCTGACTCT
CTAACTCCCTC -> TAACTCCCTCA
CTAACTTGGCG -> TAACTTGGCGT
CTAATGGTAGC -> TAATGGTAGCA
CTAATTGGATC -> TAATTGGATCC
CTACCACACGT -> TACCACACGTC
CTACCCTGTAG -> TACCCTGTAGA
CTACCGAATAG -> TACCGAATAGA
CTACCGGACGA -> TACCGGACGAG
CTACGACTGAT -> TACGACTGATG
CTACGATCGAT -> TACGATCGATA
CTACTGAAAAG -> TACTGAAAAGA
CTACTGCGTGA -> TACTGCGTGAC
CTAGACTCTAC -> TAGACTCTACC
CTAGCACTCGG -> TAGCACTCGGT
CTAGGGCAGGT -> TAGGGCAGGTA
CTAGTCACTTT -> TAGTCACTTTT
CTATACGGGCG -> TATACGGGCGC
CTATAGTAAAT -> TATAGTAAATA
CTATCCGGCGG -> TATCCGGCGGG
CTATCGCTTAT -> TATCGCTTATA
CTATGGAGCAT -> TATGGAGCATC
CTATTCTTGAA -> TATTCTTGAAG
CTATTGCTATG -> TATTGCTATGG
CTCAACACCAA -> TCAACACCAAC
CTCAATTACTA -> TCAATTACTAT
CTCACCTAGAC -> TCACCTAGACT
CTCACGCGACT -> TCACGCGACTG
CTCAGAAAACG -> TCAGAAAACGG
CTCAGTAAGGG -> TCAGTAAGGGT
CTCAGTTCCCC -> TCAGTTCCCCT
CTCATCCTTAT -> TCATCCTTATA
CTCCAATGGGT -> TCCAATGGGTC
CTCCACTTCGA -> TCCACTTCGAC
CTCCAGTAGGA -> TCCAGTAGGAC
CTCCATAACTG -> TCCATAACTGA
CTCCCCTATAG -> TCCCCTATAGT
CTCCCTACCGA -> TCCCTACCGAA
CTCCCTCAGTA -> TCCCTCAGTAA
CTCCTCCCCTA -> TCCTCCCCTAT
CTCCTCTGTGA -> TCCTCTGTGAA
CTCCTGCACCA -> TCCTGCACCAG
CTCCTTACCAA -> TCCTTACCAAT
CTCGGTTCGTA -> TCGGTTCGTAA
CTCGTGTGAAT -> TCGTGTGAATT
CTCTAACTTGG -> TCTAACTTGGC
CTCTACCCTGT -> TCTACCCTGTA
CTCTCTTCCAC -> TCTCTTCCACT
CTCTGACTGGA -> TCTGACTGGAC
CTCTGCATCGT -> TCTGCATCGTA
CTCTGTGAAGT -> TCTGTGAAGTT
CTCTTCCACTT -> TCTTCCACTTT
CTCTTTCGATT -> TCTTTCGATTG
CTGAAAAGAAT -> TGAAAAGAATA
CTGACACGCGT -> TGACACGCGTC
CTGACGGTCGA -> TGACGGTCGAT
CTGACTCTTTC -> TGACTCTTTCG
CTGACTGGACA -> TGACTGGACAT
CTGAGAAGCGG -> TGAGAAGCGGG
CTGAGTTACAA -> TGAGTTACAAT
CTGATAGGACG -> TGATAGGACGT
CTGATGATACA -> TGATGATACAA
CTGATGTGGCT -> TGATGTGGCTT
CTGCAAAGTGG -> TGCAAAGTGGT
CTGCAAGGGAG -> TGCAAGGGAGC
CTGCACCAGTG -> TGCACCAGTGG
CTGCATCGTAT -> TGCATCGTATA
CTGCGCACCCG -> TGCGCACCCGC
CTGCGGCATTT -> TGCGGCATTTA
CTGCGTAATAG -> TGCGTAATAGA
CTGCGTGACCT -> TGCGTGACCTA
CTGGAAAACGA -> TGGAAAACGAG
CTGGACATATT -> TGGACATATTT
CTGGATGTCCG -> TGGATGTCCGT
CTGGGCACGAG -> TGGGCACGAGA
CTGGGTTGCCA -> TGGGTTGCCAC
CTGGTCAACAA -> TGGTCAACAAA
CTGGTGATTGC -> TGGTGATTGCT
CTGTACAGCTA -> TGTACAGCTAC
CTGTAGAACCG -> TGTAGAACCGA
CTGTCCAACCC -> TGTCCAACCCA
CTGTCGGCGTC -> TGTCGGCGTCG
CTGTCGGTCCT -> TGTCGGTCCTA
CTGTGAAGTTT -> TGTGAAGTTTA
CTGTGTGGATG -> TGTGTGGATGC
CTTAAAGGGAT -> TTAAAGGGATA
CTTAAGTTCAT -> TTAAGTTCATG
CTTACAGCTTA -> TTACAGCTTAG
CTTACAGGTCC -> TTACAGGTCCC
CTTACCAATTT -> TTACCAATTTT
CTTACTTACAG -> TTACTTACAGC
CTTAGTGATTA -> TTAGTGATTAG
CTTAGTTTGCA -> TTAGTTTGCAA
CTTATAGCCTC -> TTATAGCCTCA
CTTATAGTCGC -> TTATAGTCGCG
CTTATCGTATT -> TTATCGTATTA
CTTATTTGTCT -> TTATTTGTCTC
CTTCCACTTTA -> TTCCACTTTAT
CTTCCGCGATT -> TTCCGCGATTG
CTTCGACCCGT -> TTCGACCCGTT
CTTCGCTCTGA -> TTCGCTCTGAC
CTTCTAGGGCA -> TTCTAGGGCAG
CTTCTGACGGT -> TTCTGACGGTC
CTTGAAGCAAT -> TTGAAGCAATA
CTTGAGGTCCC -> TTGAGGTCCCG
CTTGCTAATTG -> TTGCTAATTGG
CTTGGCGTTCC -> TTGGCGTTCCT
CTTTATAACAA -> TTTATAACAAA
CTTTCGATTGC -> TTTCGATTGCA
CTTTTAATCTG -> TTTTAATCTGA
CTTTTGTAGGA -> TTTTGTAGGAC
GAAAACAGCCT -> AAAACAGCCTT
GAAAACGAGGT -> AAAACGAGGTA
GAAAACGGCGC -> AAAACGGCGCA
GAAAAGAATAA -> AAAAGAATAAC
GAAACAACTTG -> AAACAACTTGA
GAAACTGTGTG -> AAACTGTGTGG
GAAAGTTTCGA -> AAAGTTTCGAC
GAAATATACGG -> AAATATACGGG
GAACCGATAGG -> AACCGATAGGT
GAACGCTGGGC -> AACGCTGGGCA
GAACGGGGTTT -> AACGGGGTTTT
GAACGTGCAAT -> AACGTGCAATG
GAACTATTCTT -> AACTATTCTTG
GAACTGCAAGG -> AACTGCAAGGG
GAACTTATTTG -> AACTTATTTGT
GAAGCAATAGC -> AAGCAATAGCT
GAAGCCTGTAC -> AAGCCTGTACA
GAAGCGGGGAG -> AAGCGGGGAGG
GAAGGCCTGAT -> AAGGCCTGATA
GAAGTTTAAAA -> AAGTTTAAAAT
GAATAACTGCG -> AATAACTGCGC
GAATAGAGCGG -> AATAGAGCGGC
GAATGGGAGTC -> AATGGGAGTCT
GAATTTGTAAG -> AATTTGTAAGT
GACACGCGTCA -> ACACGCGTCAG
GACATAGACAT -> ACATAGACATT
GACATATTTGT -> ACATATTTGTG
GACATGAGTAT -> ACATGAGTATG
GACATGTTTGT -> ACATGTTTGTT
GACATTACAGC -> ACATTACAGCC
GACATTACCAG -> ACATTACCAGT
GACCCACAGAC -> ACCCACAGACT
GACCCGTTCTG -> ACCCGTTCTGA
GACCGAACTGC -> ACCGAACTGCA
GACCGGTGCGA -> ACCGGTGCGAT
GACCTAATGGT -> ACCTAATGGTA
GACCTGCAAAG -> ACCTGCAAAGT
GACGAAACTGT -> ACGAAACTGTG
GACGACGGGCG -> ACGACGGGCGC
GACGAGACCGG -> ACGAGACCGGT
GACGAGTCGAG -> ACGAGTCGAGA
GACGATATGGT -> ACGATATGGTG
GACGGGCGCCG -> ACGGGCGCCGA
GACGGTCGAAA -> ACGGTCGAAAC
GACGGTCGATT -> ACGGTCGATTC
GACGTGCGCAG -> ACGTGCGCAGC
GACGTGGGAAT -> ACGTGGGAATG
GACTCCAGTAG -> ACTCCAGTAGG
GACTCTACCCT -> ACTCTACCCTG
GACTCTTTCGA -> ACTCTTTCGAT
GACTGATGTGG -> ACTGATGTGGC
GACTGGACATA -> ACTGGACATAT
GACTGGTGATT -> ACTGGTGATTG
GACTGTCGGTC -> ACTGTCGGTCC
GACTTAAAGGG -> ACTTAAAGGGA
GACTTACAGGT -> ACTTACAGGTC
GACTTATCGTA -> ACTTATCGTAT
GACTTCTAGGG -> ACTTCTAGGGC
GAGAAGCGGGG -> AGAAGCGGGGA
GAGACCGGTGC -> AGACCGGTGCG
GAGACGTGCGC -> AGACGTGCGCA
GAGAGCAATAC -> AGAGCAATACA
GAGATAAATCA -> AGATAAATCAT
GAGATTGTGGC -> AGATTGTGGCA
GAGCAATACAG -> AGCAATACAGA
GAGCATCATTT -> AGCATCATTTT
GAGCGGATGGC -> AGCGGATGGCC
GAGCGGCGCAT -> AGCGGCGCATA
GAGCTGCGGCA -> AGCTGCGGCAT
GAGGCATTCTG -> AGGCATTCTGT
GAGGCCGTCGA -> AGGCCGTCGAG
GAGGGGGGAAC -> AGGGGGGAACT
GAGGGGGTGGC -> AGGGGGTGGCA
GAGGTAAGGCC -> AGGTAAGGCCG
GAGGTATTCCC -> AGGTATTCCCC
GAGGTCCCGAT -> AGGTCCCGATG
GAGGTGAGGCA -> AGGTGAGGCAT
GAGGTTCAAGT -> AGGTTCAAGTT
GAGTATCACTC -> AGTATCACTCC
GAGTATGCCTC -> AGTATGCCTCC
GAGTCGAGAGC -> AGTCGAGAGCA
GAGTCGGGTTC -> AGTCGGGTTCT
GAGTCTCAGTT -> AGTCTCAGTTC
GAGTGCCGAGC -> AGTGCCGAGCT
GAGTTACAATT -> AGTTACAATTG
GATAAATCATC -> ATAAATCATCC
GATAAGCGCGA -> ATAAGCGCGAT
GATACAAGGTA -> ATACAAGGTAT
GATACATTGGC -> ATACATTGGCG
GATAGGACGTG -> ATAGGACGTGG
GATAGGTGACG -> ATAGGTGACGA
GATATAACGAA -> ATATAACGAAG
GATATGGTGGG -> ATATGGTGGGT
GATATTCTGGA -> ATATTCTGGAT
GATATTGCAGT -> ATATTGCAGTC
GATCACAAGGC -> ATCACAAGGCC
GATCCGGCTGG -> ATCCGGCTGGT
GATCCTACTGC -> ATCCTACTGCG
GATCCTTCGCT -> ATCCTTCGCTC
GATCGATATAA -> ATCGATATAAC
GATCGGAGTAT -> ATCGGAGTATC
GATGATACAAG -> ATGATACAAGG
GATGCTACGAC -> ATGCTACGACT
GATGGCCCTTG -> ATGGCCCTTGC
GATGTATCCTC -> ATGTATCCTCC
GATGTCCGTAA -> ATGTCCGTAAT
GATGTGGCTTC -> ATGTGGCTTCT
GATGTTCTCTG -> ATGTTCTCTGC
GATGTTGTCTT -> ATGTTGTCTTT
GATTAGCCGCG -> ATTAGCCGCGT
GATTCAGTGCC -> ATTCAGTGCCG
GATTCCATCCA -> ATTCCATCCAG
GATTCGTAACA -> ATTCGTAACAA
GATTCTCCCTA -> ATTCTCCCTAC
GATTGACTCCA -> ATTGACTCCAG
GATTGCATTAA -> ATTGCATTAAA
GATTGCTCAAT -> ATTGCTCAATT
GATTGGCGACG -> ATTGGCGACGA
GATTGTGGCAC -> ATTGTGGCACC
GATTTCATCCC -> ATTTCATCCCC
GCAAAGAGATA -> CAAAGAGATAA
GCAAAGTGGTC -> CAAAGTGGTCG
GCAACCTGGAA -> CAACCTGGAAA
GCAAGGGAGCG -> CAAGGGAGCGG
GCAATACAGAT -> CAATACAGATC
GCAATAGCTCT -> CAATAGCTCTA
GCAATGTAATG -> CAATGTAATGT
GCACCACAATA -> CACCACAATAA
GCACCAGTGGG -> CACCAGTGGGG
GCACCCCCGCC -> CACCCCCGCCA
GCACCCGCAAA -> CACCCGCAAAG
GCACCGCATTG -> CACCGCATTGA
GCACGAGACGT -> CACGAGACGTG
GCACGATCCGG -> CACGATCCGGC
GCACTCGGTTC -> CACTCGGTTCG
GCAGCATACGA -> CAGCATACGAG
GCAGCGGACAT -> CAGCGGACATG
GCAGGCTCACC -> CAGGCTCACCT
GCAGGTAATTC -> CAGGTAATTCG
GCAGTCAGTTA -> CAGTCAGTTAC
GCATACAAATC -> CATACAAATCA
GCATACGAGAT -> CATACGAGATT
GCATCATTTTT -> CATCATTTTTT
GCATCGTATAA -> CATCGTATAAC
GCATTAAAGAC -> CATTAAAGACC
GCATTCTGTCC -> CATTCTGTCCA
GCATTGAACTA -> CATTGAACTAT
GCATTGATTCT -> CATTGATTCTC
GCATTTAATGA -> CATTTAATGAT
GCCAAAATAGA -> CCAAAATAGAG
GCCAACATGTC -> CCAACATGTCG
GCCACTACTGA -> CCACTACTGAA
GCCAGAACGTG -> CCAGAACGTGC
GCCCTAGTCAC -> CCCTAGTCACT
GCCCTCACGCG -> CCCTCACGCGA
GCCCTTGCTAA -> CCCTTGCTAAT
GCCGAAAGTTT -> CCGAAAGTTTC
GCCGACCTGCA -> CCGACCTGCAA
GCCGAGCTGCG -> CCGAGCTGCGG
GCCGCGTGATT -> CCGCGTGATTG
GCCGCGTTAGA -> CCGCGTTAGAG
GCCGTAAGAAC -> CCGTAAGAACG
GCCGTACAACG -> CCGTACAACGT
GCCGTCGAGGT -> CCGTCGAGGTA
GCCGTGATACA -> CCGTGATACAT
GCCTAACTCCC -> CCTAACTCCCT
GCCTCAGAAAA -> CCTCAGAAAAC
GCCTCCAATGG -> CCTCCAATGGG
GCCTGATAGGA -> CCTGATAGGAC
GCCTGTACAGC -> CCTGTACAGCT
GCCTGTCGGCG -> CCTGTCGGCGT
GCCTTCCGCGA -> CCTTCCGCGAT
GCGAAGCCTGT -> CGAAGCCTGTA
GCGACGACGGG -> CGACGACGGGC
GCGACTGGTGA -> CGACTGGTGAT
GCGATATTCTG -> CGATATTCTGG
GCGATGTATCC -> CGATGTATCCT
GCGATTGACTC -> CGATTGACTCC
GCGATTTCATC -> CGATTTCATCC
GCGCACCCGCA -> CGCACCCGCAA
GCGCAGCGGAC -> CGCAGCGGACA
GCGCAGGCTCA -> CGCAGGCTCAC
GCGCATACAAA -> CGCATACAAAT
GCGCCGAAAGT -> CGCCGAAAGTT
GCGCCTGTCGG -> CGCCTGTCGGC
GCGCGAAGCCT -> CGCGAAGCCTG
GCGCGATATTC -> CGCGATATTCT
GCGCTACCACA -> CGCTACCACAC
GCGCTTACTTA -> CGCTTACTTAC
GCGGACATGAG -> CGGACATGAGT
GCGGACTTAAA -> CGGACTTAAAG
GCGGATGGCCC -> CGGATGGCCCT
GCGGCATTTAA -> CGGCATTTAAT
GCGGCGCATAC -> CGGCGCATACA
GCGGGGAGGTG -> CGGGGAGGTGA
GCGGGTTATGT -> CGGGTTATGTA
GCGGTACGACG -> CGGTACGACGG
GCGTAATAGAA -> CGTAATAGAAA
GCGTCAGACTT -> CGTCAGACTTA
GCGTCGGAACG -> CGTCGGAACGG
GCGTGACCTAA -> CGTGACCTAAT
GCGTGATTGGC -> CGTGATTGGCG
GCGTTAGAGGC -> CGTTAGAGGCC
GCGTTCCTTAG -> CGTTCCTTAGT
GCTAATTGGAT -> CTAATTGGATC
GCTACCACACG -> CTACCACACGT
GCTACCGGACG -> CTACCGGACGA
GCTACGACTGA -> CTACGACTGAT
GCTATGGAGCA -> CTATGGAGCAT
GCTCAATTACT -> CTCAATTACTA
GCTCACCTAGA -> CTCACCTAGAC
GCTCCACTTCG -> CTCCACTTCGA
GCTCCATAACT -> CTCCATAACTG
GCTCCTCCCCT -> CTCCTCCCCTA
GCTCTAACTTG -> CTCTAACTTGG
GCTCTGACTGG -> CTCTGACTGGA
GCTGATGATAC -> CTGATGATACA
GCTGCGGCATT -> CTGCGGCATTT
GCTGGGCACGA -> CTGGGCACGAG
GCTGGTCAACA -> CTGGTCAACAA
GCTTACTTACA -> CTTACTTACAG
GCTTAGTTTGC -> CTTAGTTTGCA
GCTTATAGCCT -> CTTATAGCCTC
GCTTCTGACGG -> CTTCTGACGGT
GGAAAACGAGG -> GAAAACGAGGT
GGAACGGGGTT -> GAACGGGGTTT
GGAACTTATTT -> GAACTTATTTG
GGAATGGGAGT -> GAATGGGAGTC
GGACATAGACA -> GACATAGACAT
GGACATATTTG -> GACATATTTGT
GGACATGAGTA -> GACATGAGTAT
GGACATGTTTG -> GACATGTTTGT
GGACATTACAG -> GACATTACAGC
GGACCGAACTG -> GACCGAACTGC
GGACGAGTCGA -> GACGAGTCGAG
GGACGTGGGAA -> GACGTGGGAAT
GGACTTAAAGG -> GACTTAAAGGG
GGACTTATCGT -> GACTTATCGTA
GGAGCATCATT -> GAGCATCATTT
GGAGCGGATGG -> GAGCGGATGGC
GGAGGTGAGGC -> GAGGTGAGGCA
GGAGTATCACT -> GAGTATCACTC
GGAGTCTCAGT -> GAGTCTCAGTT
GGAGTGCCGAG -> GAGTGCCGAGC
GGATATTGCAG -> GATATTGCAGT
GGATCCTACTG -> GATCCTACTGC
GGATCCTTCGC -> GATCCTTCGCT
GGATGCTACGA -> GATGCTACGAC
GGATGGCCCTT -> GATGGCCCTTG
GGATGTCCGTA -> GATGTCCGTAA
GGCACCGCATT -> GCACCGCATTG
GGCACGAGACG -> GCACGAGACGT
GGCACGATCCG -> GCACGATCCGG
GGCAGGTAATT -> GCAGGTAATTC
GGCATTCTGTC -> GCATTCTGTCC
GGCATTTAATG -> GCATTTAATGA
GGCCAAAATAG -> GCCAAAATAGA
GGCCCTTGCTA -> GCCCTTGCTAA
GGCCGTAAGAA -> GCCGTAAGAAC
GGCCGTCGAGG -> GCCGTCGAGGT
GGCCTGATAGG -> GCCTGATAGGA
GGCGACGACGG -> GCGACGACGGG
GGCGCAGGCTC -> GCGCAGGCTCA
GGCGCATACAA -> GCGCATACAAA
GGCGCCGAAAG -> GCGCCGAAAGT
GGCGCGAAGCC -> GCGCGAAGCCT
GGCGCTTACTT -> GCGCTTACTTA
GGCGGACTTAA -> GCGGACTTAAA
GGCGGGTTATG -> GCGGGTTATGT
GGCGGTACGAC -> GCGGTACGACG
GGCGTCGGAAC -> GCGTCGGAACG
GGCGTTCCTTA -> GCGTTCCTTAG
GGCTCACCTAG -> GCTCACCTAGA
GGCTGATGATA -> GCTGATGATAC
GGCTGGTCAAC -> GCTGGTCAACA
GGCTTCTGACG -> GCTTCTGACGG
GGGAACTTATT -> GGAACTTATTT
GGGAATGGGAG -> GGAATGGGAGT
GGGAGCGGATG -> GGAGCGGATGG
GGGAGGTGAGG -> GGAGGTGAGGC
GGGAGTCTCAG -> GGAGTCTCAGT
GGGAGTGCCGA -> GGAGTGCCGAG
GGGATATTGCA -> GGATATTGCAG
GGGCACGAGAC -> GGCACGAGACG
GGGCAGGTAAT -> GGCAGGTAATT
GGGCGCCGAAA -> GGCGCCGAAAG
GGGCGCGAAGC -> GGCGCGAAGCC
GGGCGCTTACT -> GGCGCTTACTT
GGGCGGACTTA -> GGCGGACTTAA
GGGGAACTTAT -> GGGAACTTATT
GGGGAGGTGAG -> GGGAGGTGAGG
GGGGAGTGCCG -> GGGAGTGCCGA
GGGGGAACTTA -> GGGGAACTTAT
GGGGGGAACTT -> GGGGGAACTTA
GGGGGTCTGGG -> GGGGTCTGGGT
GGGGGTGGCAC -> GGGGTGGCACG
GGGGTCTGGGT -> GGGTCTGGGTT
GGGGTGGCACG -> GGGTGGCACGA
GGGGTTTTCGC -> GGGTTTTCGCA
GGGTATGGCTG -> GGTATGGCTGA
GGGTCAACTAT -> GGTCAACTATC
GGGTCCCGCGC -> GGTCCCGCGCC
GGGTCTGGGTT -> GGTCTGGGTTG
GGGTGGCACGA -> GGTGGCACGAT
GGGTTATGTAT -> GGTTATGTATC
GGGTTCTATAC -> GGTTCTATACG
GGGTTGCCACT -> GGTTGCCACTA
GGGTTTTCGCA -> GGTTTTCGCAT
GGTAAGGCCGT -> GTAAGGCCGTA
GGTAATTCGCC -> GTAATTCGCCC
GGTACGACGGT -> GTACGACGGTC
GGTAGCACCAC -> GTAGCACCACA
GGTATAGAGTC -> GTATAGAGTCG
GGTATGGCTGA -> GTATGGCTGAT
GGTATTCCCCC -> GTATTCCCCCC
GGTCAACAAAA -> GTCAACAAAAA
GGTCAACCTCC -> GTCAACCTCCT
GGTCAACTATC -> GTCAACTATCC
GGTCCCATTTC -> GTCCCATTTCC
GGTCCCGATGT -> GTCCCGATGTT
GGTCCCGCGCC -> GTCCCGCGCCT
GGTCCTAGCAC -> GTCCTAGCACT
GGTCGAAACAA -> GTCGAAACAAC
GGTCGATTCGT -> GTCGATTCGTA
GGTCGCCGTGA -> GTCGCCGTGAT
GGTCTGGGTTG -> GTCTGGGTTGC
GGTGACGAGAC -> GTGACGAGACC
GGTGAGGCATT -> GTGAGGCATTC
GGTGATTGCTC -> GTGATTGCTCA
GGTGCGATTTC -> GTGCGATTTCA
GGTGGACCGAA -> GTGGACCGAAC
GGTGGCACGAT -> GTGGCACGATC
GGTGGGTATGG -> GTGGGTATGGC
GGTTATGTATC -> GTTATGTATCA
GGTTCAAGTTC -> GTTCAAGTTCG
GGTTCGTAAAG -> GTTCGTAAAGA
GGTTCTATACG -> GTTCTATACGG
GGTTGCCACTA -> GTTGCCACTAC
GGTTTTCGCAT -> GTTTTCGCATT
GTAAAGACTTC -> TAAAGACTTCT
GTAAATAGTTG -> TAAATAGTTGT
GTAACAAAATT -> TAACAAAATTA
GTAAGAACGCT -> TAAGAACGCTG
GTAAGGCCGTA -> TAAGGCCGTAA
GTAAGGGTCAA -> TAAGGGTCAAC
GTAAGTGCAGC -> TAAGTGCAGCA
GTAATAGAAAT -> TAATAGAAATA
GTAATGTGGAT -> TAATGTGGATC
GTAATTCGCCC -> TAATTCGCCCT
GTAATTGTATC -> TAATTGTATCG
GTACAACGTCA -> TACAACGTCAC
GTACAGCTACC -> TACAGCTACCG
GTACGACGGTC -> TACGACGGTCG
GTAGAACCGAT -> TAGAACCGATA
GTAGCACCACA -> TAGCACCACAA
GTAGGACATAG -> TAGGACATAGA
GTAGGACATTA -> TAGGACATTAC
GTATAACCTAC -> TATAACCTACG
GTATAGAGTCG -> TATAGAGTCGG
GTATCACTCCT -> TATCACTCCTT
GTATCAGGGGG -> TATCAGGGGGT
GTATCCTCCTC -> TATCCTCCTCT
GTATCGGACAC -> TATCGGACACA
GTATGCCTCCA -> TATGCCTCCAA
GTATGGCTGAT -> TATGGCTGATG
GTATTATTAGC -> TATTATTAGCG
GTATTCCCCCC -> TATTCCCCCCG
GTCAACAAAAA -> TCAACAAAAAA
GTCAACCTCCT -> TCAACCTCCTG
GTCAACTATCC -> TCAACTATCCG
GTCACGTGTGA -> TCACGTGTGAC
GTCACTTTTAA -> TCACTTTTAAT
GTCAGACTTAC -> TCAGACTTACA
GTCAGTTACCG -> TCAGTTACCGG
GTCCAACCCAA -> TCCAACCCAAC
GTCCCATTTCC -> TCCCATTTCCG
GTCCCGATGTT -> TCCCGATGTTC
GTCCCGCGCCT -> TCCCGCGCCTG
GTCCGTAATTG -> TCCGTAATTGT
GTCCTAGCACT -> TCCTAGCACTC
GTCGAAACAAC -> TCGAAACAACT
GTCGAGAGCAA -> TCGAGAGCAAT
GTCGAGGTAAG -> TCGAGGTAAGG
GTCGATTCCAT -> TCGATTCCATC
GTCGATTCGTA -> TCGATTCGTAA
GTCGCCGTGAT -> TCGCCGTGATA
GTCGCGATGTA -> TCGCGATGTAT
GTCGGAACGGG -> TCGGAACGGGG
GTCGGCGTCGG -> TCGGCGTCGGA
GTCGGGTTCTA -> TCGGGTTCTAT
GTCGGTCCTAG -> TCGGTCCTAGC
GTCGTGCCCTC -> TCGTGCCCTCA
GTCTCAGTTCC -> TCTCAGTTCCC
GTCTCTCTTCC -> TCTCTCTTCCA
GTCTGGGTTGC -> TCTGGGTTGCC
GTCTTTTGTAG -> TCTTTTGTAGG
GTGAAGTTTAA -> TGAAGTTTAAA
GTGAATTTGTA -> TGAATTTGTAA
GTGACCTAATG -> TGACCTAATGG
GTGACGAAACT -> TGACGAAACTG
GTGACGAGACC -> TGACGAGACCG
GTGAGGCATTC -> TGAGGCATTCT
GTGATACATTG -> TGATACATTGG
GTGATTAGCCG -> TGATTAGCCGC
GTGATTGCTCA -> TGATTGCTCAA
GTGATTGGCGA -> TGATTGGCGAC
GTGCAATGTAA -> TGCAATGTAAT
GTGCACCCCCG -> TGCACCCCCGC
GTGCAGCATAC -> TGCAGCATACG
GTGCCCTCACG -> TGCCCTCACGC
GTGCCGACCTG -> TGCCGACCTGC
GTGCCGAGCTG -> TGCCGAGCTGC
GTGCCGCGTTA -> TGCCGCGTTAG
GTGCGATTTCA -> TGCGATTTCAT
GTGCGCAGCGG -> TGCGCAGCGGA
GTGGACCGAAC -> TGGACCGAACT
GTGGATCCTTC -> TGGATCCTTCG
GTGGATGCTAC -> TGGATGCTACG
GTGGCACCGCA -> TGGCACCGCAT
GTGGCACGATC -> TGGCACGATCC
GTGGCTTCTGA -> TGGCTTCTGAC
GTGGGAATGGG -> TGGGAATGGGA
GTGGGGAGTGC -> TGGGGAGTGCC
GTGGGTATGGC -> TGGGTATGGCT
GTGGTCGCCGT -> TGGTCGCCGTG
GTGTGAATTTG -> TGTGAATTTGT
GTGTGACGAAA -> TGTGACGAAAC
GTGTGCACCCC -> TGTGCACCCCC
GTGTGGATGCT -> TGTGGATGCTA
GTTACAATTGA -> TTACAATTGAG
GTTACCGGACA -> TTACCGGACAT
GTTAGAGGCCG -> TTAGAGGCCGT
GTTATGTATCA -> TTATGTATCAG
GTTCAAGTTCG -> TTCAAGTTCGA
GTTCATGCTCC -> TTCATGCTCCA
GTTCCCCTTAA -> TTCCCCTTAAG
GTTCCTTAGTG -> TTCCTTAGTGA
GTTCGATGTTG -> TTCGATGTTGT
GTTCGTAAAGA -> TTCGTAAAGAC
GTTCTATACGG -> TTCTATACGGG
GTTCTCTGCAT -> TTCTCTGCATC
GTTCTGACTCT -> TTCTGACTCTT
GTTGCCACTAC -> TTGCCACTACT
GTTGTCTTTTG -> TTGTCTTTTGT
GTTGTGTGCAC -> TTGTGTGCACC
GTTTAAAATGG -> TTTAAAATGGT
GTTTAGATAAG -> TTTAGATAAGC
GTTTCACCTCG -> TTTCACCTCGT
GTTTCGACGAT -> TTTCGACGATA
GTTTGCAACCT -> TTTGCAACCTG
GTTTGTTTCAC -> TTTGTTTCACC
GTTTTCGCATT -> TTTTCGCATTG
TAAAATGGTGG -> AAAATGGTGGA
TAAAGACCCAC -> AAAGACCCACA
TAAAGACTTCT -> AAAGACTTCTA
TAAAGGGATAT -> AAAGGGATATT
TAAATAGTTGT -> AAATAGTTGTG
TAAATCATCCT -> AAATCATCCTG
TAACAAAATTA -> AACAAAATTAC
TAACAAATACC -> AACAAATACCA
TAACCTACGAT -> AACCTACGATC
TAACGAAGGCC -> AACGAAGGCCT
TAACTCCCTCA -> AACTCCCTCAG
TAACTGAGTTA -> AACTGAGTTAC
TAACTGCGCAC -> AACTGCGCACC
TAACTTGGCGT -> AACTTGGCGTT
TAAGAACGCTG -> AAGAACGCTGG
TAAGCGCGATA -> AAGCGCGATAT
TAAGGCCGTAA -> AAGGCCGTAAG
TAAGGGCGGAC -> AAGGGCGGACT
TAAGGGTCAAC -> AAGGGTCAACT
TAAGTGCAGCA -> AAGTGCAGCAT
TAAGTTCATGC -> AAGTTCATGCT
TAATAGAAATA -> AATAGAAATAT
TAATCTGACAC -> AATCTGACACG
TAATGATTCAG -> AATGATTCAGT
TAATGGTAGCA -> AATGGTAGCAC
TAATGTGGATC -> AATGTGGATCC
TAATTCGCCCT -> AATTCGCCCTA
TAATTGGATCC -> AATTGGATCCT
TAATTGTATCG -> AATTGTATCGG
TACAAATCAAG -> ACAAATCAAGG
TACAACGTCAC -> ACAACGTCACG
TACAAGGTATA -> ACAAGGTATAG
TACAATTGAGG -> ACAATTGAGGG
TACAGATCGGA -> ACAGATCGGAG
TACAGCCAGAA -> ACAGCCAGAAC
TACAGCTACCG -> ACAGCTACCGG
TACAGCTTAGT -> ACAGCTTAGTT
TACAGGTCCCA -> ACAGGTCCCAT
TACATTGGCGG -> ACATTGGCGGT
TACCAATTTTC -> ACCAATTTTCC
TACCACACGTC -> ACCACACGTCG
TACCAGGTCAA -> ACCAGGTCAAC
TACCAGTTTAG -> ACCAGTTTAGA
TACCCTGTAGA -> ACCCTGTAGAA
TACCGAATAGA -> ACCGAATAGAG
TACCGGACATG -> ACCGGACATGT
TACCGGACGAG -> ACCGGACGAGT
TACGACGGTCG -> ACGACGGTCGA
TACGACTGATG -> ACGACTGATGT
TACGAGATTGT -> ACGAGATTGTG
TACGATCGATA -> ACGATCGATAT
TACGGGCGCGA -> ACGGGCGCGAA
TACGGGCGCTT -> ACGGGCGCTTA
TACTATTGCTA -> ACTATTGCTAT
TACTGAAAAGA -> ACTGAAAAGAA
TACTGCGTAAT -> ACTGCGTAATA
TACTGCGTGAC -> ACTGCGTGACC
TACTTACAGCT -> ACTTACAGCTT
TAGAAATATAC -> AGAAATATACG
TAGAACCGATA -> AGAACCGATAG
TAGACATTACC -> AGACATTACCA
TAGACTCTACC -> AGACTCTACCC
TAGAGCGGCGC -> AGAGCGGCGCA
TAGAGGCCGTC -> AGAGGCCGTCG
TAGAGGTTCAA -> AGAGGTTCAAG
TAGAGTCGGGT -> AGAGTCGGGTT
TAGATAAGCGC -> AGATAAGCGCG
TAGCACCACAA -> AGCACCACAAT
TAGCACTCGGT -> AGCACTCGGTT
TAGCCGCGTGA -> AGCCGCGTGAT
TAGCCTCAGAA -> AGCCTCAGAAA
TAGCGCTACCA -> AGCGCTACCAC
TAGCTCTAACT -> AGCTCTAACTT
TAGGACATAGA -> AGGACATAGAC
TAGGACATTAC -> AGGACATTACA
TAGGACGTGGG -> AGGACGTGGGA
TAGGGCAGGTA -> AGGGCAGGTAA
TAGGTGACGAG -> AGGTGACGAGA
TAGTAAATAGT -> AGTAAATAGTT
TAGTCACTTTT -> AGTCACTTTTA
TAGTCGCGATG -> AGTCGCGATGT
TAGTGATTAGC -> AGTGATTAGCC
TAGTTGTGTGC -> AGTTGTGTGCA
TAGTTTGCAAC -> AGTTTGCAACC
TATAACAAATA -> ATAACAAATAC
TATAACCTACG -> ATAACCTACGA
TATAACGAAGG -> ATAACGAAGGC
TATACGGGCGC -> ATACGGGCGCG,ATACGGGCGCT
TATAGAGTCGG -> ATAGAGTCGGG
TATAGCCTCAG -> ATAGCCTCAGA
TATAGTAAATA -> ATAGTAAATAG
TATAGTCGCGA -> ATAGTCGCGAT
TATCACTCCTT -> ATCACTCCTTA
TATCAGGGGGT -> ATCAGGGGGTC
TATCCGGCGGG -> ATCCGGCGGGT
TATCCTCCTCT -> ATCCTCCTCTG
TATCGCTTATA -> ATCGCTTATAG
TATCGGACACA -> ATCGGACACAT
TATCGTATTAT -> ATCGTATTATT
TATGCCTCCAA -> ATGCCTCCAAT
TATGGAGCATC -> ATGGAGCATCA
TATGGCTGATG -> ATGGCTGATGA
TATGGTGGGTA -> ATGGTGGGTAT
TATGTATCAGG -> ATGTATCAGGG
TATTAGCGCTA -> ATTAGCGCTAC
TATTATTAGCG -> ATTATTAGCGC
TATTCCCCCCG -> ATTCCCCCCGC
TATTCTGGATG -> ATTCTGGATGT
TATTCTTGAAG -> ATTCTTGAAGC
TATTGCAGTCA -> ATTGCAGTCAG
TATTGCTATGG -> ATTGCTATGGA
TATTTGTCTCT -> ATTTGTCTCTC
TATTTGTGCCG -> ATTTGTGCCGC
TCAAAGCCTAA -> CAAAGCCTAAC
TCAACAAAAAA -> CAACAAAAAAG
TCAACACCAAC -> CAACACCAACT
TCAACCTCCTG -> CAACCTCCTGC
TCAACTATCCG -> CAACTATCCGG
TCAAGGACTTA -> CAAGGACTTAT
TCAAGTTCGAT -> CAAGTTCGATG
TCAATTACTAT -> CAATTACTATT
TCACAAGGCCA -> CACAAGGCCAA
TCACCTAGACT -> CACCTAGACTC
TCACCTCGTGT -> CACCTCGTGTG
TCACGCGACTG -> CACGCGACTGG
TCACGTGTGAC -> CACGTGTGACG
TCACTCCTTAC -> CACTCCTTACC
TCACTTTTAAT -> CACTTTTAATC
TCAGAAAACGG -> CAGAAAACGGC
TCAGACTTACA -> CAGACTTACAG
TCAGGGGGTCT -> CAGGGGGTCTG
TCAGTAAGGGT -> CAGTAAGGGTC
TCAGTGCCGAC -> CAGTGCCGACC
TCAGTTACCGG -> CAGTTACCGGA
TCAGTTCCCCT -> CAGTTCCCCTT
TCATCCCCACC -> CATCCCCACCT
TCATCCTGAGA -> CATCCTGAGAA
TCATCCTTATA -> CATCCTTATAG
TCATGCTCCAC -> CATGCTCCACT
TCATTTTTTCA -> CATTTTTTCAA
TCCAACCCAAC -> CCAACCCAACA
TCCAATGGGTC -> CCAATGGGTCC
TCCACTTCGAC -> CCACTTCGACC
TCCACTTTATA -> CCACTTTATAA
TCCAGATCACA -> CCAGATCACAA
TCCAGTAGGAC -> CCAGTAGGACA
TCCATAACTGA -> CCATAACTGAG
TCCATCCAGAT -> CCATCCAGATC
TCCCATTTCCG -> CCCATTTCCGC
TCCCCACCTCA -> CCCCACCTCAT
TCCCCCCGCTC -> CCCCCCGCTCC
TCCCCTATAGT -> CCCCTATAGTA
TCCCCTTAAGT -> CCCCTTAAGTT
TCCCGATGTTC -> CCCGATGTTCT
TCCCGCGCCTG -> CCCGCGCCTGT
TCCCTACCGAA -> CCCTACCGAAT
TCCCTCAGTAA -> CCCTCAGTAAG
TCCGCCGTACA -> CCGCCGTACAA
TCCGCGATTGA -> CCGCGATTGAC
TCCGGCGGGTT -> CCGGCGGGTTA
TCCGGCTGGTC -> CCGGCTGGTCA
TCCGTAATTGT -> CCGTAATTGTA
TCCTACTGCGT -> CCTACTGCGTG
TCCTAGCACTC -> CCTAGCACTCG
TCCTCAACACC -> CCTCAACACCA
TCCTCCCCTAT -> CCTCCCCTATA
TCCTCCTCTGT -> CCTCCTCTGTG
TCCTCTGTGAA -> CCTCTGTGAAG
TCCTGAGAAGC -> CCTGAGAAGCG
TCCTGCACCAG -> CCTGCACCAGT
TCCTTACCAAT -> CCTTACCAATT
TCCTTAGTGAT -> CCTTAGTGATT
TCCTTATAGTC -> CCTTATAGTCG
TCCTTCGCTCT -> CCTTCGCTCTG
TCGAAACAACT -> CGAAACAACTT
TCGACCCGTTC -> CGACCCGTTCT
TCGACGATATG -> CGACGATATGG
TCGAGAGCAAT -> CGAGAGCAATA
TCGAGGTAAGG -> CGAGGTAAGGC
TCGATATAACG -> CGATATAACGA
TCGATGTTGTC -> CGATGTTGTCT
TCGATTCCATC -> CGATTCCATCC
TCGATTCGTAA -> CGATTCGTAAC
TCGATTGCATT -> CGATTGCATTA
TCGCATTGATT -> CGCATTGATTC
TCGCCCTAGTC -> CGCCCTAGTCA
TCGCCGTGATA -> CGCCGTGATAC
TCGCGATGTAT -> CGCGATGTATC
TCGCTCTGACT -> CGCTCTGACTG
TCGCTTATAGC -> CGCTTATAGCC
TCGGAACGGGG -> CGGAACGGGGT
TCGGACACATC -> CGGACACATCT
TCGGAGTATCA -> CGGAGTATCAC
TCGGCGTCGGA -> CGGCGTCGGAA
TCGGGTTCTAT -> CGGGTTCTATA
TCGGTCCTAGC -> CGGTCCTAGCA
TCGGTTCGTAA -> CGGTTCGTAAA
TCGTAAAGACT -> CGTAAAGACTT
TCGTAACAAAA -> CGTAACAAAAT
TCGTATAACCT -> CGTATAACCTA
TCGTATTATTA -> CGTATTATTAG
TCGTGCCCTCA -> CGTGCCCTCAC
TCGTGTGAATT -> CGTGTGAATTT
TCTAACTTGGC -> CTAACTTGGCG
TCTACCCTGTA -> CTACCCTGTAG
TCTAGGGCAGG -> CTAGGGCAGGT
TCTATACGGGC -> CTATACGGGCG
TCTCAGTTCCC -> CTCAGTTCCCC
TCTCCCTACCG -> CTCCCTACCGA
TCTCTCTTCCA -> CTCTCTTCCAC
TCTCTGCATCG -> CTCTGCATCGT
TCTCTTCCACT -> CTCTTCCACTT
TCTGACACGCG -> CTGACACGCGT
TCTGACGGTCG -> CTGACGGTCGA
TCTGACTCTTT -> CTGACTCTTTC
TCTGACTGGAC -> CTGACTGGACA
TCTGCATCGTA -> CTGCATCGTAT
TCTGGATGTCC -> CTGGATGTCCG
TCTGGGTTGCC -> CTGGGTTGCCA
TCTGTCCAACC -> CTGTCCAACCC
TCTGTGAAGTT -> CTGTGAAGTTT
TCTTCCACTTT -> CTTCCACTTTA
TCTTGAAGCAA -> CTTGAAGCAAT
TCTTTCGATTG -> CTTTCGATTGC
TCTTTTGTAGG -> CTTTTGTAGGA
TGAAAAGAATA -> GAAAAGAATAA
TGAACTATTCT -> GAACTATTCTT
TGAAGCAATAG -> GAAGCAATAGC
TGAAGTTTAAA -> GAAGTTTAAAA
TGAATTTGTAA -> GAATTTGTAAG
TGACACGCGTC -> GACACGCGTCA
TGACCTAATGG -> GACCTAATGGT
TGACGAAACTG -> GACGAAACTGT
TGACGAGACCG -> GACGAGACCGG
TGACGGTCGAT -> GACGGTCGATT
TGACTCCAGTA -> GACTCCAGTAG
TGACTCTTTCG -> GACTCTTTCGA
TGACTGGACAT -> GACTGGACATA
TGAGAAGCGGG -> GAGAAGCGGGG
TGAGGCATTCT -> GAGGCATTCTG
TGAGGGGGTGG -> GAGGGGGTGGC
TGAGGTCCCGA -> GAGGTCCCGAT
TGAGTATGCCT -> GAGTATGCCTC
TGAGTTACAAT -> GAGTTACAATT
TGATACAAGGT -> GATACAAGGTA
TGATACATTGG -> GATACATTGGC
TGATAGGACGT -> GATAGGACGTG
TGATGATACAA -> GATGATACAAG
TGATGTGGCTT -> GATGTGGCTTC
TGATTAGCCGC -> GATTAGCCGCG
TGATTCAGTGC -> GATTCAGTGCC
TGATTCTCCCT -> GATTCTCCCTA
TGATTGCTCAA -> GATTGCTCAAT
TGATTGGCGAC -> GATTGGCGACG
TGCAAAGTGGT -> GCAAAGTGGTC
TGCAACCTGGA -> GCAACCTGGAA
TGCAAGGGAGC -> GCAAGGGAGCG
TGCAATGTAAT -> GCAATGTAATG
TGCACCAGTGG -> GCACCAGTGGG
TGCACCCCCGC -> GCACCCCCGCC
TGCAGCATACG -> GCAGCATACGA
TGCAGTCAGTT -> GCAGTCAGTTA
TGCATCGTATA -> GCATCGTATAA
TGCATTAAAGA -> GCATTAAAGAC
TGCCACTACTG -> GCCACTACTGA
TGCCCTCACGC -> GCCCTCACGCG
TGCCGACCTGC -> GCCGACCTGCA
TGCCGAGCTGC -> GCCGAGCTGCG
TGCCGCGTTAG -> GCCGCGTTAGA
TGCCTCCAATG -> GCCTCCAATGG
TGCGATTTCAT -> GCGATTTCATC
TGCGCACCCGC -> GCGCACCCGCA
TGCGCAGCGGA -> GCGCAGCGGAC
TGCGGCATTTA -> GCGGCATTTAA
TGCGTAATAGA -> GCGTAATAGAA
TGCGTGACCTA -> GCGTGACCTAA
TGCTAATTGGA -> GCTAATTGGAT
TGCTACGACTG -> GCTACGACTGA
TGCTATGGAGC -> GCTATGGAGCA
TGCTCAATTAC -> GCTCAATTACT
TGCTCCACTTC -> GCTCCACTTCG
TGGAAAACGAG -> GGAAAACGAGG
TGGACATATTT -> GGACATATTTG
TGGACCGAACT -> GGACCGAACTG
TGGAGCATCAT -> GGAGCATCATT
TGGATCCTACT -> GGATCCTACTG
TGGATCCTTCG -> GGATCCTTCGC
TGGATGCTACG -> GGATGCTACGA
TGGATGTCCGT -> GGATGTCCGTA
TGGCACCGCAT -> GGCACCGCATT
TGGCACGATCC -> GGCACGATCCG
TGGCCCTTGCT -> GGCCCTTGCTA
TGGCGACGACG -> GGCGACGACGG
TGGCGGTACGA -> GGCGGTACGAC
TGGCGTTCCTT -> GGCGTTCCTTA
TGGCTGATGAT -> GGCTGATGATA
TGGCTTCTGAC -> GGCTTCTGACG
TGGGAATGGGA -> GGGAATGGGAG
TGGGAGTCTCA -> GGGAGTCTCAG
TGGGCACGAGA -> GGGCACGAGAC
TGGGGAGTGCC -> GGGGAGTGCCG
TGGGTATGGCT -> GGGTATGGCTG
TGGGTCCCGCG -> GGGTCCCGCGC
TGGGTTGCCAC -> GGGTTGCCACT
TGGTAGCACCA -> GGTAGCACCAC
TGGTCAACAAA -> GGTCAACAAAA
TGGTCGCCGTG -> GGTCGCCGTGA
TGGTGATTGCT -> GGTGATTGCTC
TGGTGGACCGA -> GGTGGACCGAA
TGGTGGGTATG -> GGTGGGTATGG
TGTAAGTGCAG -> GTAAGTGCAGC
TGTAATGTGGA -> GTAATGTGGAT
TGTACAGCTAC -> GTACAGCTACC
TGTAGAACCGA -> GTAGAACCGAT
TGTAGGACATA -> GTAGGACATAG
TGTATCAGGGG -> GTATCAGGGGG
TGTATCCTCCT -> GTATCCTCCTC
TGTATCGGACA -> GTATCGGACAC
TGTCCAACCCA -> GTCCAACCCAA
TGTCCGTAATT -> GTCCGTAATTG
TGTCGATTCCA -> GTCGATTCCAT
TGTCGGCGTCG -> GTCGGCGTCGG
TGTCGGTCCTA -> GTCGGTCCTAG
TGTCTCTCTTC -> GTCTCTCTTCC
TGTCTTTTGTA -> GTCTTTTGTAG
TGTGAAGTTTA -> GTGAAGTTTAA
TGTGAATTTGT -> GTGAATTTGTA
TGTGACGAAAC -> GTGACGAAACT
TGTGCACCCCC -> GTGCACCCCCG
TGTGCCGCGTT -> GTGCCGCGTTA
TGTGGATCCTT -> GTGGATCCTTC
TGTGGATGCTA -> GTGGATGCTAC
TGTGGCACCGC -> GTGGCACCGCA
TGTGGCTTCTG -> GTGGCTTCTGA
TGTGTGCACCC -> GTGTGCACCCC
TGTGTGGATGC -> GTGTGGATGCT
TGTTCTCTGCA -> GTTCTCTGCAT
TGTTGTCTTTT -> GTTGTCTTTTG
TGTTTCACCTC -> GTTTCACCTCG
TGTTTGTTTCA -> GTTTGTTTCAC
TTAAAATGGTG -> TAAAATGGTGG
TTAAAGACCCA -> TAAAGACCCAC
TTAAAGGGATA -> TAAAGGGATAT
TTAAGTTCATG -> TAAGTTCATGC
TTAATCTGACA -> TAATCTGACAC
TTAATGATTCA -> TAATGATTCAG
TTACAATTGAG -> TACAATTGAGG
TTACAGCCAGA -> TACAGCCAGAA
TTACAGCTTAG -> TACAGCTTAGT
TTACAGGTCCC -> TACAGGTCCCA
TTACCAATTTT -> TACCAATTTTC
TTACCAGTTTA -> TACCAGTTTAG
TTACCGGACAT -> TACCGGACATG
TTACTATTGCT -> TACTATTGCTA
TTACTGCGTAA -> TACTGCGTAAT
TTACTTACAGC -> TACTTACAGCT
TTAGAGGCCGT -> TAGAGGCCGTC
TTAGATAAGCG -> TAGATAAGCGC
TTAGCCGCGTG -> TAGCCGCGTGA
TTAGCGCTACC -> TAGCGCTACCA
TTAGTGATTAG -> TAGTGATTAGC
TTAGTTTGCAA -> TAGTTTGCAAC
TTATAACAAAT -> TATAACAAATA
TTATAGCCTCA -> TATAGCCTCAG
TTATAGTCGCG -> TATAGTCGCGA
TTATCGTATTA -> TATCGTATTAT
TTATGTATCAG -> TATGTATCAGG
TTATTAGCGCT -> TATTAGCGCTA
TTATTTGTCTC -> TATTTGTCTCT
TTCAAAGCCTA -> TCAAAGCCTAA
TTCAAGTTCGA -> TCAAGTTCGAT
TTCACCTCGTG -> TCACCTCGTGT
TTCAGTGCCGA -> TCAGTGCCGAC
TTCATCCCCAC -> TCATCCCCACC
TTCATGCTCCA -> TCATGCTCCAC
TTCCACTTTAT -> TCCACTTTATA
TTCCATCCAGA -> TCCATCCAGAT
TTCCCCCCGCT -> TCCCCCCGCTC
TTCCCCTTAAG -> TCCCCTTAAGT
TTCCGCCGTAC -> TCCGCCGTACA
TTCCGCGATTG -> TCCGCGATTGA
TTCCTCAACAC -> TCCTCAACACC
TTCCTTAGTGA -> TCCTTAGTGAT
TTCGACCCGTT -> TCGACCCGTTC
TTCGACGATAT -> TCGACGATATG
TTCGATGTTGT -> TCGATGTTGTC
TTCGATTGCAT -> TCGATTGCATT
TTCGCATTGAT -> TCGCATTGATT
TTCGCCCTAGT -> TCGCCCTAGTC
TTCGCTCTGAC -> TCGCTCTGACT
TTCGTAAAGAC -> TCGTAAAGACT
TTCGTAACAAA -> TCGTAACAAAA
TTCTAGGGCAG -> TCTAGGGCAGG
TTCTATACGGG -> TCTATACGGGC
TTCTCCCTACC -> TCTCCCTACCG
TTCTCTGCATC -> TCTCTGCATCG
TTCTGACGGTC -> TCTGACGGTCG
TTCTGACTCTT -> TCTGACTCTTT
TTCTGGATGTC -> TCTGGATGTCC
TTCTGTCCAAC -> TCTGTCCAACC
TTCTTGAAGCA -> TCTTGAAGCAA
TTGAACTATTC -> TGAACTATTCT
TTGAAGCAATA -> TGAAGCAATAG
TTGACTCCAGT -> TGACTCCAGTA
TTGAGGGGGTG -> TGAGGGGGTGG
TTGAGGTCCCG -> TGAGGTCCCGA
TTGATTCTCCC -> TGATTCTCCCT
TTGCAACCTGG -> TGCAACCTGGA
TTGCAGTCAGT -> TGCAGTCAGTT
TTGCATTAAAG -> TGCATTAAAGA
TTGCCACTACT -> TGCCACTACTG
TTGCTAATTGG -> TGCTAATTGGA
TTGCTATGGAG -> TGCTATGGAGC
TTGCTCAATTA -> TGCTCAATTAC
TTGGATCCTAC -> TGGATCCTACT
TTGGCGACGAC -> TGGCGACGACG
TTGGCGGTACG -> TGGCGGTACGA
TTGGCGTTCCT -> TGGCGTTCCTT
TTGTAAGTGCA -> TGTAAGTGCAG
TTGTAGGACAT -> TGTAGGACATA
TTGTATCGGAC -> TGTATCGGACA
TTGTCTCTCTT -> TGTCTCTCTTC
TTGTCTTTTGT -> TGTCTTTTGTA
TTGTGCCGCGT -> TGTGCCGCGTT
TTGTGGCACCG -> TGTGGCACCGC
TTGTGTGCACC -> TGTGTGCACCC
TTGTTTCACCT -> TGTTTCACCTC
TTTAAAATGGT -> TTAAAATGGTG
TTTAATCTGAC -> TTAATCTGACA
TTTAATGATTC -> TTAATGATTCA
TTTAGATAAGC -> TTAGATAAGCG
TTTATAACAAA -> TTATAACAAAT
TTTCAAAGCCT -> TTCAAAGCCTA
TTTCACCTCGT -> TTCACCTCGTG
TTTCATCCCCA -> TTCATCCCCAC
TTTCCGCCGTA -> TTCCGCCGTAC
TTTCCTCAACA -> TTCCTCAACAC
TTTCGACGATA -> TTCGACGATAT
TTTCGATTGCA -> TTCGATTGCAT
TTTCGCATTGA -> TTCGCATTGAT
TTTGCAACCTG -> TTGCAACCTGG
TTTGTAAGTGC -> TTGTAAGTGCA
TTTGTAGGACA -> TTGTAGGACAT
TTTGTCTCTCT -> TTGTCTCTCTT
TTTGTGCCGCG -> TTGTGCCGCGT
TTTGTTTCACC -> TTGTTTCACCT
TTTTAATCTGA -> TTTAATCTGAC
TTTTCAAAGCC -> TTTCAAAGCCT
TTTTCCTCAAC -> TTTCCTCAACA
TTTTCGCATTG -> TTTCGCATTGA
TTTTGTAGGAC -> TTTGTAGGACA
TTTTTCAAAGC -> TTTTCAAAGCC
TTTTTTCAAAG -> TTTTTCAAAGC
